sg_uf,nm_municipio,aa_eleicao,qt_eleitor_apto,qt_eleitor_comp,qt_eleitor_abstencao,pct_eleitor_abstencao
AC,ACRELÂNDIA,2022,9529,7297,2232,0.234232343
AC,ASSIS BRASIL,2022,6388,5018,1370,0.214464621
AC,BRASILÉIA,2022,18230,14567,3663,0.200932529
AC,BUJARI,2022,9941,7525,2416,0.2430339
AC,CAPIXABA,2022,7843,6172,1671,0.213056228
AC,CRUZEIRO DO SUL,2022,59505,46952,12553,0.210957062
AC,EPITACIOLÂNDIA,2022,12531,9952,2579,0.205809592
AC,FEIJÓ,2022,22789,15891,6898,0.302689894
AC,JORDÃO,2022,5594,4145,1449,0.259027529
AC,MANOEL URBANO,2022,7779,5765,2014,0.258902173
AC,MARECHAL THAUMATURGO,2022,11337,8257,3080,0.27167681
AC,MÂNCIO LIMA,2022,13786,10580,3206,0.232554766
AC,PLÁCIDO DE CASTRO,2022,12286,9694,2592,0.210971838
AC,PORTO ACRE,2022,13195,10592,2603,0.197271694
AC,PORTO WALTER,2022,7214,5637,1577,0.218602717
AC,RIO BRANCO,2022,266883,210912,55971,0.209721114
AC,RODRIGUES ALVES,2022,11784,9087,2697,0.228869654
AC,SANTA ROSA DO PURUS,2022,3771,2612,1159,0.307345532
AC,SENA MADUREIRA,2022,30369,22510,7859,0.258783628
AC,SENADOR GUIOMARD,2022,17851,14246,3605,0.201949471
AC,TARAUACÁ,2022,27701,19387,8314,0.300133569
AC,XAPURI,2022,12127,9710,2417,0.199307331
AL,ANADIA,2022,12675,9039,3636,0.286863905
AL,ARAPIRACA,2022,150627,121879,28748,0.190855557
AL,ATALAIA,2022,31344,23655,7689,0.245310107
AL,BARRA DE SANTO ANTÔNIO,2022,12534,9723,2811,0.224269986
AL,BARRA DE SÃO MIGUEL,2022,7332,6137,1195,0.162984179
AL,BATALHA,2022,13071,9937,3134,0.239767424
AL,BELO MONTE,2022,6038,4653,1385,0.22938059
AL,BELÉM,2022,4978,3659,1319,0.26496585
AL,BOCA DA MATA,2022,19605,14195,5410,0.275950013
AL,BRANQUINHA,2022,9101,6369,2732,0.300186793
AL,CACIMBINHAS,2022,8465,6200,2265,0.267572357
AL,CAJUEIRO,2022,14548,10501,4047,0.278182568
AL,CAMPESTRE,2022,5666,4190,1476,0.260501235
AL,CAMPO ALEGRE,2022,25843,18902,6941,0.268583369
AL,CAMPO GRANDE,2022,8956,6885,2071,0.231241626
AL,CANAPI,2022,13660,9695,3965,0.290263543
AL,CAPELA,2022,12940,9932,3008,0.232457496
AL,CARNEIROS,2022,6965,5234,1731,0.248528356
AL,CHÃ PRETA,2022,6097,4617,1480,0.242742332
AL,COITÉ DO NÓIA,2022,8912,6911,2001,0.224528725
AL,COLÔNIA LEOPOLDINA,2022,14861,10828,4033,0.271381468
AL,COQUEIRO SECO,2022,5018,4210,808,0.161020327
AL,CORURIPE,2022,40193,30487,9706,0.241484836
AL,CRAÍBAS,2022,19339,15375,3964,0.204974404
AL,DELMIRO GOUVEIA,2022,39075,29601,9474,0.242456814
AL,DOIS RIACHOS,2022,9311,6754,2557,0.274621416
AL,ESTRELA DE ALAGOAS,2022,12008,8259,3749,0.312208528
AL,FEIRA GRANDE,2022,17920,13989,3931,0.219363839
AL,FELIZ DESERTO,2022,3521,2572,949,0.269525703
AL,FLEXEIRAS,2022,8678,6452,2226,0.256510717
AL,GIRAU DO PONCIANO,2022,27348,20271,7077,0.258775779
AL,IBATEGUARA,2022,11372,8340,3032,0.266619768
AL,IGACI,2022,20128,14469,5659,0.281150636
AL,IGREJA NOVA,2022,17555,13519,4036,0.22990601
AL,INHAPI,2022,13307,9489,3818,0.28691666
AL,JACARÉ DOS HOMENS,2022,4911,3729,1182,0.240684178
AL,JACUÍPE,2022,5691,4418,1273,0.223686523
AL,JAPARATINGA,2022,7175,5723,1452,0.202369338
AL,JARAMATAIA,2022,4987,3923,1064,0.213354722
AL,JEQUIÁ DA PRAIA,2022,7943,6334,1609,0.202568299
AL,JOAQUIM GOMES,2022,14305,10856,3449,0.241104509
AL,JUNDIÁ,2022,4482,3310,1172,0.261490406
AL,JUNQUEIRO,2022,19830,14978,4852,0.244679778
AL,LAGOA DA CANOA,2022,15113,11945,3168,0.209620856
AL,LIMOEIRO DE ANADIA,2022,19066,14834,4232,0.221965803
AL,MACEIÓ,2022,627485,507606,119879,0.191046798
AL,MAJOR ISIDORO,2022,15258,11376,3882,0.254423909
AL,MAR VERMELHO,2022,3541,2917,624,0.176221406
AL,MARAGOGI,2022,22524,17566,4958,0.22012076
AL,MARAVILHA,2022,8135,5960,2175,0.267363245
AL,MARECHAL DEODORO,2022,41017,33228,7789,0.189896872
AL,MARIBONDO,2022,10337,8138,2199,0.212730966
AL,MATA GRANDE,2022,17752,12435,5317,0.299515548
AL,MATRIZ DE CAMARAGIBE,2022,18503,13633,4870,0.263200562
AL,MESSIAS,2022,13612,10529,3083,0.226491331
AL,MINADOR DO NEGRÃO,2022,4910,3718,1192,0.242769857
AL,MONTEIRÓPOLIS,2022,5980,4330,1650,0.275919732
AL,MURICI,2022,20081,15210,4871,0.242567601
AL,NOVO LINO,2022,9866,7303,2563,0.259781066
AL,OLHO D'ÁGUA DAS FLORES,2022,16034,12068,3966,0.247349383
AL,OLHO D'ÁGUA DO CASADO,2022,7454,5503,1951,0.261738664
AL,OLHO D'ÁGUA GRANDE,2022,4833,3608,1225,0.253465756
AL,OLIVENÇA,2022,9641,7352,2289,0.237423504
AL,OURO BRANCO,2022,9229,7163,2066,0.223859573
AL,PALESTINA,2022,4755,3451,1304,0.274237645
AL,PALMEIRA DOS ÍNDIOS,2022,52692,41497,11195,0.212461095
AL,PARICONHA,2022,9079,6721,2358,0.259720234
AL,PARIPUEIRA,2022,11081,8883,2198,0.198357549
AL,PASSO DE CAMARAGIBE,2022,11917,9424,2493,0.209196946
AL,PAULO JACINTO,2022,6259,4935,1324,0.211535389
AL,PENEDO,2022,42150,31642,10508,0.249300119
AL,PIAÇABUÇU,2022,13590,10406,3184,0.234289919
AL,PILAR,2022,27285,21590,5695,0.208722741
AL,PINDOBA,2022,2673,2149,524,0.196034418
AL,PIRANHAS,2022,18931,13998,4933,0.260577888
AL,PORTO CALVO,2022,20930,15835,5095,0.243430483
AL,PORTO DE PEDRAS,2022,7062,5611,1451,0.205465874
AL,PORTO REAL DO COLÉGIO,2022,16153,12705,3448,0.2134588
AL,POÇO DAS TRINCHEIRAS,2022,10470,7959,2511,0.23982808
AL,PÃO DE AÇÚCAR,2022,18801,14161,4640,0.246795383
AL,QUEBRANGULO,2022,10048,7657,2391,0.237957803
AL,RIO LARGO,2022,62255,50977,11278,0.18115814
AL,ROTEIRO,2022,5569,4254,1315,0.236128569
AL,SANTA LUZIA DO NORTE,2022,6101,5086,1015,0.166366169
AL,SANTANA DO IPANEMA,2022,32098,25149,6949,0.216493239
AL,SANTANA DO MUNDAÚ,2022,9009,6693,2316,0.257076257
AL,SATUBA,2022,12499,10458,2041,0.163293063
AL,SENADOR RUI PALMEIRA,2022,9310,6741,2569,0.27593985
AL,SÃO BRÁS,2022,6688,5240,1448,0.216507177
AL,SÃO JOSÉ DA LAJE,2022,17375,12923,4452,0.256230216
AL,SÃO JOSÉ DA TAPERA,2022,21640,15421,6219,0.287384473
AL,SÃO LUÍS DO QUITUNDE,2022,23467,17172,6295,0.268249031
AL,SÃO MIGUEL DOS CAMPOS,2022,42525,33283,9242,0.217330982
AL,SÃO MIGUEL DOS MILAGRES,2022,7374,5742,1632,0.221318145
AL,SÃO SEBASTIÃO,2022,25963,19630,6333,0.243924046
AL,TANQUE D'ARCA,2022,5495,3999,1496,0.272247498
AL,TAQUARANA,2022,14168,10629,3539,0.249788255
AL,TEOTÔNIO VILELA,2022,30681,21665,9016,0.293862651
AL,TRAIPU,2022,18358,13588,4770,0.259832226
AL,UNIÃO DOS PALMARES,2022,46272,34482,11790,0.254797718
AL,VIÇOSA,2022,20297,15799,4498,0.221609105
AL,ÁGUA BRANCA,2022,15950,11136,4814,0.301818182
AM,ALVARÃES,2022,11366,8717,2649,0.233063523
AM,AMATURÁ,2022,6814,5424,1390,0.203991782
AM,ANAMÃ,2022,8676,6487,2189,0.25230521
AM,ANORI,2022,10845,8239,2606,0.240295067
AM,APUÍ,2022,11716,7959,3757,0.320672584
AM,ATALAIA DO NORTE,2022,9046,6275,2771,0.306323237
AM,AUTAZES,2022,28953,21983,6970,0.240734984
AM,BARCELOS,2022,11837,7586,4251,0.359128157
AM,BARREIRINHA,2022,21126,16789,4337,0.205292057
AM,BENJAMIN CONSTANT,2022,22308,16989,5319,0.238434642
AM,BERURI,2022,13842,10438,3404,0.24591822
AM,BOA VISTA DO RAMOS,2022,12727,9708,3019,0.237212226
AM,BOCA DO ACRE,2022,23042,16280,6762,0.293464109
AM,BORBA,2022,20957,16630,4327,0.206470392
AM,CAAPIRANGA,2022,9630,7133,2497,0.259293873
AM,CANUTAMA,2022,10086,7051,3035,0.300912155
AM,CARAUARI,2022,21605,14137,7468,0.345660727
AM,CAREIRO,2022,24256,17599,6657,0.274447559
AM,CAREIRO DA VÁRZEA,2022,16774,13051,3723,0.221950638
AM,COARI,2022,51739,36086,15653,0.302537737
AM,CODAJÁS,2022,16506,11954,4552,0.275778505
AM,EIRUNEPÉ,2022,20144,14608,5536,0.274821287
AM,ENVIRA,2022,12125,7566,4559,0.376
AM,FONTE BOA,2022,16488,11800,4688,0.284327996
AM,GUAJARÁ,2022,11839,7994,3845,0.324774052
AM,HUMAITÁ,2022,32902,24443,8459,0.257096833
AM,IPIXUNA,2022,11984,7752,4232,0.353137517
AM,IRANDUBA,2022,36599,30850,5749,0.157080795
AM,ITACOATIARA,2022,71241,55012,16229,0.227804214
AM,ITAMARATI,2022,7423,5171,2252,0.303381382
AM,ITAPIRANGA,2022,8357,6465,1892,0.226397032
AM,JAPURÁ,2022,5149,3438,1711,0.332297534
AM,JURUÁ,2022,7915,5362,2553,0.322552116
AM,JUTAÍ,2022,14371,9544,4827,0.335884768
AM,LÁBREA,2022,27161,19213,7948,0.292625456
AM,MANACAPURU,2022,72802,57672,15130,0.207823961
AM,MANAQUIRI,2022,14599,10978,3621,0.248030687
AM,MANAUS,2022,1415958,1200210,215748,0.152368926
AM,MANICORÉ,2022,33205,24583,8622,0.25965969
AM,MARAÃ,2022,10148,6147,4001,0.39426488
AM,MAUÉS,2022,36977,27401,9576,0.258971793
AM,NHAMUNDÁ,2022,14389,11209,3180,0.221002154
AM,NOVA OLINDA DO NORTE,2022,19088,14349,4739,0.248271165
AM,NOVO AIRÃO,2022,11516,8921,2595,0.225338659
AM,NOVO ARIPUANÃ,2022,13708,9477,4231,0.308651882
AM,PARINTINS,2022,72964,55341,17623,0.24153007
AM,PAUINI,2022,11419,7736,3683,0.322532621
AM,PRESIDENTE FIGUEIREDO,2022,25306,18554,6752,0.266814194
AM,RIO PRETO DA EVA,2022,18180,14421,3759,0.206765677
AM,SANTA ISABEL DO RIO NEGRO,2022,8946,5603,3343,0.373686564
AM,SANTO ANTÔNIO DO IÇÁ,2022,16370,12787,3583,0.218875993
AM,SILVES,2022,8330,6520,1810,0.217286915
AM,SÃO GABRIEL DA CACHOEIRA,2022,32106,21709,10397,0.323833551
AM,SÃO PAULO DE OLIVENÇA,2022,18566,14942,3624,0.195195519
AM,SÃO SEBASTIÃO DO UATUMÃ,2022,7358,5645,1713,0.232807828
AM,TABATINGA,2022,37078,27583,9495,0.256081774
AM,TAPAUÁ,2022,14068,9753,4315,0.306724481
AM,TEFÉ,2022,42096,34093,8003,0.190113075
AM,TONANTINS,2022,10593,8142,2451,0.231379213
AM,UARINI,2022,8944,6753,2191,0.244968694
AM,URUCARÁ,2022,12284,9013,3271,0.266281342
AM,URUCURITUBA,2022,13201,9791,3410,0.258313764
AP,AMAPÁ,2022,6880,5495,1385,0.20130814
AP,CALÇOENE,2022,8294,6279,2015,0.242946708
AP,CUTIAS,2022,5054,4157,897,0.177483182
AP,FERREIRA GOMES,2022,6119,5068,1051,0.171760092
AP,ITAUBAL,2022,7359,6008,1351,0.183584726
AP,LARANJAL DO JARI,2022,28982,21344,7638,0.263542889
AP,MACAPÁ,2022,311547,253799,57748,0.18535887
AP,MAZAGÃO,2022,19191,16448,2743,0.142931583
AP,OIAPOQUE,2022,21266,14540,6726,0.316279507
AP,PEDRA BRANCA DO AMAPARI,2022,10163,7632,2531,0.249040638
AP,PORTO GRANDE,2022,14210,10624,3586,0.252357495
AP,PRACUÚBA,2022,3740,3095,645,0.172459893
AP,SANTANA,2022,83411,69745,13666,0.163839302
AP,SERRA DO NAVIO,2022,3883,3049,834,0.214782385
AP,TARTARUGALZINHO,2022,10391,8197,2194,0.211144259
AP,VITÓRIA DO JARI,2022,10197,7810,2387,0.234088457
BA,ABARÉ,2022,14610,11986,2624,0.179603012
BA,ABAÍRA,2022,7252,5528,1724,0.237727523
BA,ACAJUTIBA,2022,12248,9227,3021,0.246652515
BA,ADUSTINA,2022,11888,9717,2171,0.182621131
BA,AIQUARA,2022,4206,3145,1061,0.252258678
BA,ALAGOINHAS,2022,111809,89573,22236,0.198874867
BA,ALCOBAÇA,2022,18853,13548,5305,0.281387578
BA,ALMADINA,2022,5170,3663,1507,0.291489362
BA,AMARGOSA,2022,28947,22116,6831,0.235983003
BA,AMÉLIA RODRIGUES,2022,19820,15738,4082,0.205953582
BA,AMÉRICA DOURADA,2022,13521,10184,3337,0.246801272
BA,ANAGÉ,2022,19755,14915,4840,0.245001266
BA,ANDARAÍ,2022,10816,7821,2995,0.276904586
BA,ANDORINHA,2022,12447,10169,2278,0.183015988
BA,ANGICAL,2022,12917,10173,2744,0.212433228
BA,ANGUERA,2022,9364,7461,1903,0.203225117
BA,ANTAS,2022,11018,8495,2523,0.228988927
BA,ANTÔNIO CARDOSO,2022,11288,9515,1773,0.157069454
BA,ANTÔNIO GONÇALVES,2022,8833,6787,2046,0.231631382
BA,APORÁ,2022,14330,10524,3806,0.26559665
BA,APUAREMA,2022,5988,4730,1258,0.21008684
BA,ARACATU,2022,11997,10266,1731,0.144286072
BA,ARACI,2022,42276,29864,12412,0.293594474
BA,ARAMARI,2022,9308,7464,1844,0.198109153
BA,ARATACA,2022,6303,4670,1633,0.259082976
BA,ARATUÍPE,2022,8596,6642,1954,0.22731503
BA,ARAÇÁS,2022,10168,8070,2098,0.206333596
BA,AURELINO LEAL,2022,9845,7319,2526,0.256576943
BA,BAIANÓPOLIS,2022,12329,9781,2548,0.206667207
BA,BAIXA GRANDE,2022,16187,11664,4523,0.279421758
BA,BANZAÊ,2022,10256,8307,1949,0.190035101
BA,BARRA,2022,38721,28031,10690,0.276077581
BA,BARRA DA ESTIVA,2022,20103,16841,3262,0.162264339
BA,BARRA DO CHOÇA,2022,29589,22351,7238,0.244617932
BA,BARRA DO MENDES,2022,12846,9918,2928,0.227930873
BA,BARRA DO ROCHA,2022,4208,3073,1135,0.269724335
BA,BARREIRAS,2022,103075,84618,18457,0.179063789
BA,BARRO ALTO,2022,10995,8708,2287,0.208003638
BA,BARRO PRETO,2022,6108,4544,1564,0.256057629
BA,BARROCAS,2022,13743,11294,2449,0.178199811
BA,BELMONTE,2022,16150,11744,4406,0.272817337
BA,BELO CAMPO,2022,16477,12208,4269,0.259088426
BA,BIRITINGA,2022,12542,10019,2523,0.201164089
BA,BOA NOVA,2022,14012,9112,4900,0.349700257
BA,BOA VISTA DO TUPIM,2022,14570,11051,3519,0.241523679
BA,BOM JESUS DA LAPA,2022,50194,38307,11887,0.236821134
BA,BOM JESUS DA SERRA,2022,9658,6807,2851,0.295195693
BA,BONINAL,2022,11206,8296,2910,0.259682313
BA,BONITO,2022,12964,9815,3149,0.242903425
BA,BOQUIRA,2022,17163,12497,4666,0.271863893
BA,BOTUPORÃ,2022,9988,7230,2758,0.276131358
BA,BREJOLÂNDIA,2022,8469,6340,2129,0.251387413
BA,BREJÕES,2022,11695,8485,3210,0.274476272
BA,BROTAS DE MACAÚBAS,2022,9566,7331,2235,0.233639975
BA,BRUMADO,2022,51226,43345,7881,0.153847655
BA,BUERAREMA,2022,12944,9668,3276,0.253090235
BA,BURITIRAMA,2022,16355,11917,4438,0.271354326
BA,CAATIBA,2022,6548,4690,1858,0.283750764
BA,CABACEIRAS DO PARAGUAÇU,2022,13452,10685,2767,0.205694321
BA,CACHOEIRA,2022,26406,20501,5905,0.223623419
BA,CACULÉ,2022,18044,14561,3483,0.193028153
BA,CAEM,2022,8004,6248,1756,0.219390305
BA,CAETANOS,2022,10634,7858,2776,0.261049464
BA,CAETITÉ,2022,42249,34660,7589,0.179625553
BA,CAFARNAUM,2022,14897,11409,3488,0.234141102
BA,CAIRU,2022,13973,11190,2783,0.199169828
BA,CALDEIRÃO GRANDE,2022,10785,7874,2911,0.269911915
BA,CAMACÃ,2022,18704,13840,4864,0.260051326
BA,CAMAMU,2022,26794,18481,8313,0.310256027
BA,CAMAÇARI,2022,191507,158540,32967,0.172145144
BA,CAMPO ALEGRE DE LOURDES,2022,25262,17974,7288,0.288496556
BA,CAMPO FORMOSO,2022,57421,45567,11854,0.206440153
BA,CANARANA,2022,20216,15838,4378,0.21656114
BA,CANAVIEIRAS,2022,24986,18271,6715,0.2687505
BA,CANDEAL,2022,7717,6335,1382,0.179085137
BA,CANDEIAS,2022,66298,53156,13142,0.198226191
BA,CANDIBA,2022,10956,8934,2022,0.184556407
BA,CANSANÇÃO,2022,30099,22972,7127,0.236785275
BA,CANUDOS,2022,13369,10230,3139,0.234796918
BA,CANÁPOLIS,2022,8897,6904,1993,0.224008093
BA,CAPELA DO ALTO ALEGRE,2022,9851,7562,2289,0.232362197
BA,CAPIM GROSSO,2022,24750,18951,5799,0.23430303
BA,CARAVELAS,2022,16459,12173,4286,0.260404642
BA,CARAÍBAS,2022,8980,6598,2382,0.265256125
BA,CARDEAL DA SILVA,2022,7980,5808,2172,0.272180451
BA,CARINHANHA,2022,23281,17609,5672,0.243632146
BA,CASA NOVA,2022,56798,46102,10696,0.18831649
BA,CASTRO ALVES,2022,23116,18087,5029,0.21755494
BA,CATOLÂNDIA,2022,3948,3235,713,0.180597771
BA,CATU,2022,41949,33470,8479,0.202126392
BA,CATURAMA,2022,7701,5744,1957,0.254122841
BA,CENTRAL,2022,13816,10852,2964,0.214533874
BA,CHORROCHÓ,2022,9255,7056,2199,0.237601297
BA,CIPÓ,2022,14412,10746,3666,0.254371357
BA,COARACI,2022,16929,12108,4821,0.284777601
BA,COCOS,2022,15759,12146,3613,0.229265816
BA,CONCEIÇÃO DA FEIRA,2022,17596,14365,3231,0.183621278
BA,CONCEIÇÃO DO ALMEIDA,2022,15352,12141,3211,0.209158416
BA,CONCEIÇÃO DO COITÉ,2022,54410,44375,10035,0.184433009
BA,CONCEIÇÃO DO JACUÍPE,2022,26796,21636,5160,0.192566055
BA,CONDE,2022,19266,14271,4995,0.259265026
BA,CONDEÚBA,2022,15946,11357,4589,0.28778377
BA,CONTENDAS DO SINCORÁ,2022,4312,3461,851,0.197356215
BA,CORAÇÃO DE MARIA,2022,22309,17686,4623,0.207225783
BA,CORDEIROS,2022,7390,5251,2139,0.289445196
BA,CORIBE,2022,12469,9670,2799,0.224476702
BA,CORONEL JOÃO SÁ,2022,13889,11378,2511,0.180790554
BA,CORRENTINA,2022,28188,20928,7260,0.257556407
BA,COTEGIPE,2022,11962,9022,2940,0.245778298
BA,CRAVOLÂNDIA,2022,4390,3183,1207,0.274943052
BA,CRISTÓPOLIS,2022,12588,9634,2954,0.234667938
BA,CRISÓPOLIS,2022,17827,12305,5522,0.309754866
BA,CRUZ DAS ALMAS,2022,47625,40333,7292,0.153112861
BA,CURAÇÁ,2022,26623,20905,5718,0.214776697
BA,CÂNDIDO SALES,2022,20166,15456,4710,0.23356144
BA,CÍCERO DANTAS,2022,26838,20293,6545,0.243870631
BA,DIAS D'ÁVILA,2022,53827,42347,11480,0.213275865
BA,DOM BASÍLIO,2022,10526,8784,1742,0.165494965
BA,DOM MACEDO COSTA,2022,4394,3678,716,0.162949477
BA,DÁRIO MEIRA,2022,8051,6040,2011,0.249782636
BA,ELÍSIO MEDRADO,2022,7868,5919,1949,0.247712252
BA,ENCRUZILHADA,2022,15409,11720,3689,0.239405542
BA,ENTRE RIOS,2022,33211,23893,9318,0.280569691
BA,ESPLANADA,2022,26970,20688,6282,0.232925473
BA,EUCLIDES DA CUNHA,2022,47234,36128,11106,0.235127239
BA,EUNÁPOLIS,2022,81805,63716,18089,0.221123403
BA,FEIRA DA MATA,2022,5467,4140,1327,0.242729102
BA,FEIRA DE SANTANA,2022,424521,360349,64172,0.151163311
BA,FILADÉLFIA,2022,15701,11700,4001,0.254824533
BA,FIRMINO ALVES,2022,5327,3829,1498,0.281208936
BA,FLORESTA AZUL,2022,8263,6077,2186,0.264552826
BA,FORMOSA DO RIO PRETO,2022,19980,15393,4587,0.22957958
BA,FÁTIMA,2022,15959,12320,3639,0.228021806
BA,GANDU,2022,23467,18426,5041,0.21481229
BA,GAVIÃO,2022,4530,3458,1072,0.236644592
BA,GENTIO DO OURO,2022,9606,7823,1783,0.185613158
BA,GLÓRIA,2022,13617,10286,3331,0.244620695
BA,GONGOGI,2022,5298,3777,1521,0.287089468
BA,GOVERNADOR MANGABEIRA,2022,17816,14152,3664,0.205657836
BA,GUAJERU,2022,7438,4938,2500,0.336111858
BA,GUANAMBI,2022,64990,54760,10230,0.157408832
BA,GUARATINGA,2022,16007,11528,4479,0.279815081
BA,HELIÓPOLIS,2022,11875,9483,2392,0.201431579
BA,IAÇU,2022,22287,14991,7296,0.327365729
BA,IBIASSUCÊ,2022,8946,6933,2013,0.225016767
BA,IBICARAÍ,2022,19397,14465,4932,0.254266124
BA,IBICOARA,2022,15289,12475,2814,0.184053895
BA,IBICUÍ,2022,12020,9096,2924,0.243261231
BA,IBIPEBA,2022,13848,11042,2806,0.202628538
BA,IBIPITANGA,2022,13488,9659,3829,0.283881969
BA,IBIQUERA,2022,3992,3041,951,0.238226453
BA,IBIRAPITANGA,2022,13760,10452,3308,0.240406977
BA,IBIRAPUÃ,2022,7563,5889,1674,0.221340738
BA,IBIRATAIA,2022,15476,11549,3927,0.253747738
BA,IBITIARA,2022,11503,9170,2333,0.202816657
BA,IBITITÁ,2022,15321,12666,2655,0.173291561
BA,IBOTIRAMA,2022,21308,16555,4753,0.223061761
BA,ICHU,2022,5863,4914,949,0.161862528
BA,IGAPORÃ,2022,12291,10118,2173,0.17679603
BA,IGRAPIÚNA,2022,10117,6838,3279,0.324107937
BA,IGUAÍ,2022,20251,13812,6439,0.317959607
BA,ILHÉUS,2022,128420,103805,24615,0.191675751
BA,INHAMBUPE,2022,28089,21239,6850,0.243867706
BA,IPECAETÁ,2022,14151,11447,2704,0.191081902
BA,IPIAÚ,2022,31800,24892,6908,0.217232704
BA,IPIRÁ,2022,46754,37027,9727,0.20804637
BA,IPUPIARA,2022,8604,6802,1802,0.209437471
BA,IRAJUBA,2022,5396,4146,1250,0.231653076
BA,IRAMAIA,2022,9183,6712,2471,0.269084177
BA,IRAQUARA,2022,18617,15101,3516,0.188859644
BA,IRARÁ,2022,25627,19529,6098,0.23795216
BA,IRECÊ,2022,48833,41027,7806,0.15985092
BA,ITABELA,2022,24266,16759,7507,0.309362895
BA,ITABERABA,2022,48894,39507,9387,0.191986747
BA,ITABUNA,2022,156529,117673,38856,0.248235151
BA,ITACARÉ,2022,18613,14080,4533,0.243539462
BA,ITAETÉ,2022,11436,8261,3175,0.277632039
BA,ITAGI,2022,10263,7611,2652,0.258403975
BA,ITAGIBÁ,2022,12140,9253,2887,0.237808896
BA,ITAGIMIRIM,2022,6131,4499,1632,0.266188224
BA,ITAGUAÇU DA BAHIA,2022,10868,8360,2508,0.230769231
BA,ITAJU DO COLÔNIA,2022,5518,4080,1438,0.260601667
BA,ITAJUÍPE,2022,17692,13014,4678,0.264413294
BA,ITAMARAJU,2022,47640,35646,11994,0.251763224
BA,ITAMARI,2022,6674,4823,1851,0.277344921
BA,ITAMBÉ,2022,20056,14548,5508,0.274631033
BA,ITANAGRA,2022,6327,4643,1684,0.266160898
BA,ITANHÉM,2022,16440,11445,4995,0.303832117
BA,ITAPARICA,2022,18363,14839,3524,0.19190764
BA,ITAPEBI,2022,8105,5886,2219,0.273781616
BA,ITAPETINGA,2022,49897,38782,11115,0.222758883
BA,ITAPICURU,2022,24950,17898,7052,0.282645291
BA,ITAPITANGA,2022,6770,4676,2094,0.309305761
BA,ITAPÉ,2022,9387,6627,2760,0.29402365
BA,ITAQUARA,2022,6528,4964,1564,0.239583333
BA,ITARANTIM,2022,14442,10778,3664,0.253704473
BA,ITATIM,2022,12891,10103,2788,0.21627492
BA,ITIRUÇU,2022,9687,7231,2456,0.253535666
BA,ITIÚBA,2022,30043,21773,8270,0.27527211
BA,ITORORÓ,2022,17407,12615,4792,0.275291549
BA,ITUAÇU,2022,15565,12532,3033,0.194860263
BA,ITUBERÁ,2022,19716,13659,6057,0.307212416
BA,IUIU,2022,8866,6776,2090,0.23573201
BA,JABORANDI,2022,9160,7250,1910,0.208515284
BA,JACARACI,2022,12073,8874,3199,0.264971424
BA,JACOBINA,2022,59585,48080,11505,0.193085508
BA,JAGUAQUARA,2022,34655,26867,7788,0.224729476
BA,JAGUARARI,2022,22039,17613,4426,0.200825809
BA,JAGUARIPE,2022,15223,11951,3272,0.214937923
BA,JANDAÍRA,2022,9182,6526,2656,0.289261599
BA,JEQUIÉ,2022,114760,93901,20859,0.181761938
BA,JEREMOABO,2022,28996,22679,6317,0.217857636
BA,JIQUIRIÇÁ,2022,11597,8763,2834,0.244373545
BA,JITAÚNA,2022,12194,9559,2635,0.21608988
BA,JOÃO DOURADO,2022,19497,14833,4664,0.23921629
BA,JUAZEIRO,2022,156048,130414,25634,0.164269968
BA,JUCURUÇU,2022,8734,6491,2243,0.256812457
BA,JUSSARA,2022,13601,10574,3027,0.222557165
BA,JUSSARI,2022,5034,3499,1535,0.3049265
BA,JUSSIAPE,2022,6834,5354,1480,0.216564238
BA,LAFAIETE COUTINHO,2022,3913,3355,558,0.142601584
BA,LAGOA REAL,2022,10645,8368,2277,0.213903241
BA,LAJE,2022,20497,15780,4717,0.230131239
BA,LAJEDINHO,2022,3584,2794,790,0.220424107
BA,LAJEDO DO TABOCAL,2022,6552,4971,1581,0.241300366
BA,LAJEDÃO,2022,4787,3329,1458,0.30457489
BA,LAMARÃO,2022,8482,6013,2469,0.291087008
BA,LAPÃO,2022,22750,18398,4352,0.191296703
BA,LAURO DE FREITAS,2022,156597,123099,33498,0.213912144
BA,LENÇÓIS,2022,8223,6268,1955,0.237747781
BA,LICÍNIO DE ALMEIDA,2022,9907,7864,2043,0.206217826
BA,LIVRAMENTO DE NOSSA SENHORA,2022,35421,28283,7138,0.201518873
BA,LUÍS EDUARDO MAGALHÃES,2022,70016,55249,14767,0.210908935
BA,MACAJUBA,2022,10475,7355,3120,0.297852029
BA,MACARANI,2022,13856,9775,4081,0.294529446
BA,MACAÚBAS,2022,34869,25687,9182,0.263328458
BA,MACURURÉ,2022,6855,5262,1593,0.23238512
BA,MADRE DE DEUS,2022,15679,13253,2426,0.154729256
BA,MAETINGA,2022,7289,4798,2491,0.341747839
BA,MAIQUINIQUE,2022,7727,5765,1962,0.253914844
BA,MAIRI,2022,14607,10708,3899,0.266926816
BA,MALHADA,2022,14017,10566,3451,0.246201042
BA,MALHADA DE PEDRAS,2022,7505,6285,1220,0.162558294
BA,MANOEL VITORINO,2022,12662,9950,2712,0.214184173
BA,MANSIDÃO,2022,10628,7185,3443,0.323955589
BA,MARACÁS,2022,22204,16360,5844,0.263195821
BA,MARAGOGIPE,2022,35052,27861,7191,0.205152345
BA,MARAÚ,2022,15285,11160,4125,0.269872424
BA,MARCIONÍLIO SOUZA,2022,7897,5773,2124,0.268962897
BA,MASCOTE,2022,10028,6930,3098,0.308934982
BA,MATA DE SÃO JOÃO,2022,42183,32528,9655,0.228883674
BA,MATINA,2022,9670,7625,2045,0.2114788
BA,MEDEIROS NETO,2022,19414,14632,4782,0.246317091
BA,MIGUEL CALMON,2022,22003,16125,5878,0.267145389
BA,MILAGRES,2022,9286,7171,2115,0.227762223
BA,MIRANGABA,2022,11847,9745,2102,0.177428885
BA,MIRANTE,2022,8267,6121,2146,0.259586307
BA,MONTE SANTO,2022,44796,32516,12280,0.274131619
BA,MORPARÁ,2022,7884,5940,1944,0.246575342
BA,MORRO DO CHAPÉU,2022,26248,20556,5692,0.216854617
BA,MORTUGABA,2022,9762,7061,2701,0.276685106
BA,MUCUGÊ,2022,9729,7921,1808,0.18583616
BA,MUCURI,2022,30549,21308,9241,0.302497627
BA,MULUNGU DO MORRO,2022,11160,8584,2576,0.230824373
BA,MUNDO NOVO,2022,16096,11575,4521,0.280877237
BA,MUNIZ FERREIRA,2022,7655,6504,1151,0.150359242
BA,MUQUÉM DO SÃO FRANCISCO,2022,9714,7418,2296,0.236359893
BA,MURITIBA,2022,23148,18126,5022,0.216951788
BA,MUTUÍPE,2022,19048,14118,4930,0.258819824
BA,NAZARÉ,2022,22471,17876,4595,0.204485782
BA,NILO PEÇANHA,2022,9741,7571,2170,0.222769736
BA,NORDESTINA,2022,10823,7836,2987,0.275986325
BA,NOVA CANAÃ,2022,13232,9350,3882,0.293379686
BA,NOVA FÁTIMA,2022,7776,6185,1591,0.204603909
BA,NOVA IBIÁ,2022,5513,4095,1418,0.25721023
BA,NOVA ITARANA,2022,6585,5050,1535,0.233105543
BA,NOVA REDENÇÃO,2022,6566,4926,1640,0.24977155
BA,NOVA SOURE,2022,21686,15982,5704,0.263026838
BA,NOVA VIÇOSA,2022,32331,23311,9020,0.278989205
BA,NOVO HORIZONTE,2022,8926,7520,1406,0.157517365
BA,NOVO TRIUNFO,2022,8706,6241,2465,0.283138066
BA,OLINDINA,2022,21036,14969,6067,0.288410344
BA,OLIVEIRA DOS BREJINHOS,2022,17139,13071,4068,0.237353405
BA,OURIÇANGAS,2022,7248,5470,1778,0.245309051
BA,OUROLÂNDIA,2022,13359,10923,2436,0.182348978
BA,PALMAS DE MONTE ALTO,2022,17519,13969,3550,0.202637137
BA,PALMEIRAS,2022,7741,6302,1439,0.185893295
BA,PARAMIRIM,2022,17424,13391,4033,0.231462351
BA,PARATINGA,2022,24524,18639,5885,0.23996901
BA,PARIPIRANGA,2022,22869,18315,4554,0.199134199
BA,PAU BRASIL,2022,7928,5863,2065,0.260469223
BA,PAULO AFONSO,2022,87792,65289,22503,0.256321761
BA,PEDRO ALEXANDRE,2022,10411,7791,2620,0.251656901
BA,PEDRÃO,2022,6574,5186,1388,0.211134773
BA,PIATÃ,2022,17527,13022,4505,0.257032008
BA,PILÃO ARCADO,2022,28294,21541,6753,0.23867251
BA,PINDAÍ,2022,12927,10453,2474,0.191382378
BA,PINDOBAÇU,2022,15836,12530,3306,0.20876484
BA,PINTADAS,2022,8570,6525,2045,0.238623104
BA,PIRAÍ DO NORTE,2022,6883,5494,1389,0.20180154
BA,PIRIPÁ,2022,9709,6575,3134,0.322793285
BA,PIRITIBA,2022,14761,11213,3548,0.240363119
BA,PLANALTINO,2022,6957,5418,1539,0.221216041
BA,PLANALTO,2022,19971,15621,4350,0.217815833
BA,POJUCA,2022,28117,22490,5627,0.200128036
BA,PONTO NOVO,2022,14716,10501,4215,0.286422941
BA,PORTO SEGURO,2022,104184,80037,24147,0.231772633
BA,POTIRAGUÁ,2022,9212,6063,3149,0.341836735
BA,POÇÕES,2022,38994,28526,10468,0.268451557
BA,PRADO,2022,24656,17809,6847,0.277701168
BA,PRESIDENTE DUTRA,2022,11321,9782,1539,0.135942055
BA,PRESIDENTE JÂNIO QUADROS,2022,11959,7840,4119,0.344426792
BA,PRESIDENTE TANCREDO NEVES,2022,22059,17037,5022,0.227662179
BA,PÉ DE SERRA,2022,12102,9556,2546,0.21037845
BA,QUEIMADAS,2022,21000,15785,5215,0.248333333
BA,QUIJINGUE,2022,22118,16755,5363,0.242472195
BA,QUIXABEIRA,2022,8944,6784,2160,0.241502683
BA,RAFAEL JAMBEIRO,2022,19501,13848,5653,0.28988257
BA,REMANSO,2022,32583,24891,7692,0.236074026
BA,RETIROLÂNDIA,2022,12515,10243,2272,0.181542149
BA,RIACHO DE SANTANA,2022,24233,18641,5592,0.230759708
BA,RIACHÃO DAS NEVES,2022,20146,14885,5261,0.261143651
BA,RIACHÃO DO JACUÍPE,2022,27483,22935,4548,0.165484117
BA,RIBEIRA DO AMPARO,2022,12624,9336,3288,0.260456274
BA,RIBEIRA DO POMBAL,2022,41920,33919,8001,0.19086355
BA,RIBEIRÃO DO LARGO,2022,8110,6211,1899,0.234155364
BA,RIO DE CONTAS,2022,12375,9691,2684,0.216888889
BA,RIO DO ANTÔNIO,2022,11526,8544,2982,0.258719417
BA,RIO DO PIRES,2022,10051,6761,3290,0.327330614
BA,RIO REAL,2022,30100,22312,7788,0.258737542
BA,RODELAS,2022,7378,6088,1290,0.174844131
BA,RUY BARBOSA,2022,25127,18334,6793,0.270346639
BA,SALINAS DA MARGARIDA,2022,14282,11302,2980,0.20865425
BA,SALVADOR,2022,1983198,1627855,355343,0.179176764
BA,SANTA BRÍGIDA,2022,12437,9044,3393,0.272814988
BA,SANTA BÁRBARA,2022,19577,15851,3726,0.190325382
BA,SANTA CRUZ CABRÁLIA,2022,22279,16568,5711,0.256340051
BA,SANTA CRUZ DA VITÓRIA,2022,5040,3402,1638,0.325
BA,SANTA INÊS,2022,8610,6104,2506,0.291056911
BA,SANTA LUZIA,2022,9949,6429,3520,0.353804402
BA,SANTA MARIA DA VITÓRIA,2022,31901,24236,7665,0.2402746
BA,SANTA RITA DE CÁSSIA,2022,23558,17413,6145,0.260845573
BA,SANTA TEREZINHA,2022,9372,7052,2320,0.247545881
BA,SANTALUZ,2022,32184,25172,7012,0.217872235
BA,SANTANA,2022,21585,16465,5120,0.23720176
BA,SANTANÓPOLIS,2022,9312,7267,2045,0.219609107
BA,SANTO AMARO,2022,49910,39147,10763,0.215648167
BA,SANTO ANTÔNIO DE JESUS,2022,74781,61359,13422,0.179484094
BA,SANTO ESTEVÃO,2022,37934,31080,6854,0.180682238
BA,SAPEAÇU,2022,15426,12758,2668,0.172954752
BA,SAUBARA,2022,12771,9982,2789,0.218385404
BA,SAÚDE,2022,9319,6895,2424,0.260113746
BA,SEABRA,2022,33457,28142,5315,0.158860627
BA,SEBASTIÃO LARANJEIRAS,2022,7210,5616,1594,0.221081831
BA,SENHOR DO BONFIM,2022,52174,41968,10206,0.195614674
BA,SENTO SÉ,2022,30919,22979,7940,0.256800026
BA,SERRA DO RAMALHO,2022,26638,19598,7040,0.264284105
BA,SERRA DOURADA,2022,15365,11368,3997,0.260136674
BA,SERRA PRETA,2022,17720,13595,4125,0.23278781
BA,SERRINHA,2022,61718,51356,10362,0.167892673
BA,SERROLÂNDIA,2022,10331,8378,1953,0.189042687
BA,SIMÕES FILHO,2022,87633,70647,16986,0.193831091
BA,SOBRADINHO,2022,20026,15598,4428,0.221112554
BA,SOUTO SOARES,2022,14499,11199,3300,0.227601904
BA,SÁTIRO DIAS,2022,14390,10362,4028,0.279916609
BA,SÃO DESIDÉRIO,2022,24775,20283,4492,0.181311806
BA,SÃO DOMINGOS,2022,7919,6578,1341,0.169339563
BA,SÃO FELIPE,2022,17791,14008,3783,0.212635602
BA,SÃO FRANCISCO DO CONDE,2022,32980,26944,6036,0.183020012
BA,SÃO FÉLIX,2022,10692,8456,2236,0.20912832
BA,SÃO FÉLIX DO CORIBE,2022,12539,10171,2368,0.188850786
BA,SÃO GABRIEL,2022,15747,13236,2511,0.159458945
BA,SÃO GONÇALO DOS CAMPOS,2022,29461,24380,5081,0.172465293
BA,SÃO JOSÉ DA VITÓRIA,2022,5092,3794,1298,0.254909662
BA,SÃO JOSÉ DO JACUÍPE,2022,8823,6602,2221,0.251728437
BA,SÃO MIGUEL DAS MATAS,2022,9377,7723,1654,0.176389037
BA,SÃO SEBASTIÃO DO PASSÉ,2022,35223,27930,7293,0.20705221
BA,SÍTIO DO MATO,2022,10954,8365,2589,0.236352018
BA,SÍTIO DO QUINTO,2022,10220,7680,2540,0.24853229
BA,TABOCAS DO BREJO VELHO,2022,11069,8099,2970,0.268316921
BA,TANHAÇU,2022,17884,14466,3418,0.191120555
BA,TANQUE NOVO,2022,14549,11562,2987,0.205306207
BA,TANQUINHO,2022,7484,6129,1355,0.181052913
BA,TAPEROÁ,2022,14310,11069,3241,0.226484976
BA,TAPIRAMUTÁ,2022,12009,8392,3617,0.301190774
BA,TEIXEIRA DE FREITAS,2022,112190,81642,30548,0.272288083
BA,TEODORO SAMPAIO,2022,6935,5551,1384,0.199567412
BA,TEOFILÂNDIA,2022,18941,13658,5283,0.278918748
BA,TEOLÂNDIA,2022,11711,9012,2699,0.230467082
BA,TERRA NOVA,2022,10448,8237,2211,0.211619449
BA,TREMEDAL,2022,16552,11320,5232,0.316094732
BA,TUCANO,2022,39586,31578,8008,0.20229374
BA,UAUÁ,2022,22624,17197,5427,0.239878006
BA,UBAITABA,2022,14296,10680,3616,0.252937885
BA,UBATÃ,2022,12003,9335,2668,0.222277764
BA,UBAÍRA,2022,16791,12470,4321,0.257340242
BA,UIBAÍ,2022,12204,9850,2354,0.192887578
BA,UMBURANAS,2022,10993,8939,2054,0.186846175
BA,UNA,2022,16033,11896,4137,0.258030312
BA,URANDI,2022,13465,10253,3212,0.238544374
BA,URUÇUCA,2022,18752,13856,4896,0.26109215
BA,UTINGA,2022,13381,9829,3552,0.265451013
BA,VALENTE,2022,20058,16491,3567,0.177834281
BA,VALENÇA,2022,64598,51570,13028,0.201678071
BA,VARZEDO,2022,8725,7224,1501,0.172034384
BA,VERA CRUZ,2022,33065,27039,6026,0.182247089
BA,VEREDA,2022,6803,4994,1809,0.265912098
BA,VITÓRIA DA CONQUISTA,2022,250908,210642,40266,0.160481133
BA,VÁRZEA DA ROÇA,2022,11522,8427,3095,0.26861656
BA,VÁRZEA DO POÇO,2022,7072,5411,1661,0.23486991
BA,VÁRZEA NOVA,2022,10799,8079,2720,0.251875174
BA,WAGNER,2022,7361,5341,2020,0.274419237
BA,WANDERLEY,2022,10946,8501,2445,0.223369267
BA,WENCESLAU GUIMARÃES,2022,16899,12687,4212,0.249245517
BA,XIQUE-XIQUE,2022,36866,27092,9774,0.265122335
BA,ÁGUA FRIA,2022,13083,9774,3309,0.252923641
BA,ÉRICO CARDOSO,2022,8915,6473,2442,0.273920359
CE,ABAIARA,2022,7216,5927,1289,0.17863082
CE,ACARAPE,2022,11564,10035,1529,0.132220685
CE,ACARAÚ,2022,45458,36770,8688,0.191121475
CE,ACOPIARA,2022,39527,31096,8431,0.21329724
CE,AIUABA,2022,11783,8700,3083,0.261648137
CE,ALCÂNTARAS,2022,9680,7619,2061,0.212913223
CE,ALTANEIRA,2022,6249,5165,1084,0.173467755
CE,ALTO SANTO,2022,12800,10011,2789,0.217890625
CE,AMONTADA,2022,33515,27126,6389,0.190631061
CE,ANTONINA DO NORTE,2022,7379,5301,2078,0.281609974
CE,APUIARÉS,2022,12012,10239,1773,0.147602398
CE,AQUIRAZ,2022,61328,52712,8616,0.140490477
CE,ARACATI,2022,54824,46743,8081,0.147398949
CE,ARACOIABA,2022,24030,20560,3470,0.14440283
CE,ARARENDÁ,2022,9655,7395,2260,0.234075608
CE,ARARIPE,2022,18199,13224,4975,0.273366668
CE,ARATUBA,2022,11573,9696,1877,0.162187851
CE,ARNEIROZ,2022,7114,5443,1671,0.234888951
CE,ASSARÉ,2022,19972,14709,5263,0.263518926
CE,AURORA,2022,19943,15613,4330,0.217118789
CE,BAIXIO,2022,5605,4386,1219,0.217484389
CE,BANABUIÚ,2022,14710,12360,2350,0.159755269
CE,BARBALHA,2022,48075,40167,7908,0.16449298
CE,BARREIRA,2022,17619,15275,2344,0.133038197
CE,BARRO,2022,16708,12785,3923,0.234797702
CE,BARROQUINHA,2022,13918,11248,2670,0.191837908
CE,BATURITÉ,2022,26647,22390,4257,0.15975532
CE,BEBERIBE,2022,45021,37045,7976,0.177161769
CE,BELA CRUZ,2022,20224,16391,3833,0.189527294
CE,BOA VIAGEM,2022,41117,33074,8043,0.19561252
CE,BREJO SANTO,2022,35375,29235,6140,0.173568905
CE,CAMOCIM,2022,47998,38783,9215,0.191987166
CE,CAMPOS SALES,2022,21491,15688,5803,0.270020008
CE,CANINDÉ,2022,57656,46847,10809,0.187473984
CE,CAPISTRANO,2022,15793,13093,2700,0.170961819
CE,CARIDADE,2022,16661,14052,2609,0.156593242
CE,CARIRIAÇU,2022,24050,19440,4610,0.191683992
CE,CARIRÉ,2022,14827,12012,2815,0.189856343
CE,CARIÚS,2022,14953,12372,2581,0.172607504
CE,CARNAUBAL,2022,13876,10732,3144,0.226578265
CE,CASCAVEL,2022,56966,48220,8746,0.153530176
CE,CATARINA,2022,9554,6829,2725,0.28522085
CE,CATUNDA,2022,8550,6996,1554,0.181754386
CE,CAUCAIA,2022,235150,202950,32200,0.136933872
CE,CEDRO,2022,20209,16248,3961,0.196001781
CE,CHAVAL,2022,10768,8444,2324,0.215824666
CE,CHOROZINHO,2022,17167,14629,2538,0.147841789
CE,CHORÓ,2022,11299,9331,1968,0.174174706
CE,COREAÚ,2022,19389,15596,3793,0.195626386
CE,CRATEÚS,2022,57514,46616,10898,0.189484299
CE,CRATO,2022,92790,80205,12585,0.135628839
CE,CROATÁ,2022,14504,11162,3342,0.230419195
CE,CRUZ,2022,21415,17458,3957,0.184777025
CE,DEPUTADO IRAPUAN PINHEIRO,2022,7460,5989,1471,0.197184987
CE,ERERÉ,2022,5705,4375,1330,0.233128834
CE,EUSÉBIO,2022,49911,42470,7441,0.149085372
CE,FARIAS BRITO,2022,16120,13772,2348,0.145657568
CE,FORQUILHA,2022,18593,15859,2734,0.147044587
CE,FORTALEZA,2022,1869135,1560371,308764,0.16519085
CE,FORTIM,2022,14630,12731,1899,0.129801777
CE,FRECHEIRINHA,2022,12631,10557,2074,0.164199192
CE,GENERAL SAMPAIO,2022,7532,6085,1447,0.192113648
CE,GRANJA,2022,42392,34243,8149,0.192229666
CE,GRANJEIRO,2022,5817,4464,1353,0.232594121
CE,GRAÇA,2022,13445,9581,3864,0.287393083
CE,GROAÍRAS,2022,8960,7506,1454,0.162276786
CE,GUAIÚBA,2022,19327,16770,2557,0.132301961
CE,GUARACIABA DO NORTE,2022,32792,25523,7269,0.221669919
CE,GUARAMIRANGA,2022,5873,4914,959,0.163289631
CE,HIDROLÂNDIA,2022,14970,12297,2673,0.178557114
CE,HORIZONTE,2022,57695,49009,8686,0.150550308
CE,IBARETAMA,2022,12129,10348,1781,0.146838156
CE,IBIAPINA,2022,18689,14970,3719,0.198994061
CE,IBICUITINGA,2022,12057,10099,1958,0.162395289
CE,ICAPUÍ,2022,16509,14250,2259,0.136834454
CE,ICÓ,2022,49185,38698,10487,0.213215411
CE,IGUATU,2022,68464,58022,10442,0.152518112
CE,INDEPENDÊNCIA,2022,21885,16712,5173,0.236371944
CE,IPAPORANGA,2022,9919,7791,2128,0.214537756
CE,IPAUMIRIM,2022,9577,7475,2102,0.219484181
CE,IPU,2022,34669,25855,8814,0.254232888
CE,IPUEIRAS,2022,33912,23537,10375,0.305938901
CE,IRACEMA,2022,11999,9265,2734,0.227852321
CE,IRAUÇUBA,2022,18380,15667,2713,0.147606094
CE,ITAITINGA,2022,29828,25877,3951,0.132459434
CE,ITAIÇABA,2022,6841,5879,962,0.140622716
CE,ITAPAJÉ,2022,37772,32217,5555,0.14706661
CE,ITAPIPOCA,2022,93393,79908,13485,0.144389836
CE,ITAPIÚNA,2022,15672,12908,2764,0.176365493
CE,ITAREMA,2022,31658,25336,6322,0.199696759
CE,ITATIRA,2022,18520,14285,4235,0.228671706
CE,JAGUARETAMA,2022,15710,12345,3365,0.21419478
CE,JAGUARIBARA,2022,8660,7045,1615,0.186489607
CE,JAGUARIBE,2022,28507,22661,5846,0.205072438
CE,JAGUARUANA,2022,27649,23149,4500,0.16275453
CE,JARDIM,2022,21883,16466,5417,0.247543755
CE,JATI,2022,6814,5396,1418,0.208100969
CE,JIJOCA DE JERICOACOARA,2022,18234,14912,3322,0.182187123
CE,JUAZEIRO DO NORTE,2022,183286,154183,29103,0.158784632
CE,JUCÁS,2022,19657,15200,4457,0.226738566
CE,LAVRAS DA MANGABEIRA,2022,23336,18295,5041,0.216018169
CE,LIMOEIRO DO NORTE,2022,45707,38890,6817,0.149145645
CE,MADALENA,2022,13810,11424,2386,0.172773353
CE,MARACANAÚ,2022,168849,148595,20254,0.119953331
CE,MARANGUAPE,2022,79353,68376,10977,0.138331254
CE,MARCO,2022,21981,18205,3776,0.171784723
CE,MARTINÓPOLE,2022,9983,8536,1447,0.144946409
CE,MASSAPÊ,2022,31945,25607,6338,0.198403506
CE,MAURITI,2022,34378,27742,6636,0.193030426
CE,MERUOCA,2022,12125,10394,1731,0.142762887
CE,MILAGRES,2022,21959,17560,4399,0.200327884
CE,MILHÃ,2022,11632,9046,2586,0.222317744
CE,MIRAÍMA,2022,11571,9583,1988,0.171808832
CE,MISSÃO VELHA,2022,29154,23933,5221,0.179083488
CE,MOMBAÇA,2022,31890,24863,7027,0.220351207
CE,MONSENHOR TABOSA,2022,15753,11397,4356,0.276518758
CE,MORADA NOVA,2022,54557,45643,8914,0.163388749
CE,MORAÚJO,2022,7529,6294,1235,0.164032408
CE,MORRINHOS,2022,17436,14285,3151,0.180718055
CE,MUCAMBO,2022,13649,9612,4037,0.295772584
CE,MULUNGU,2022,8672,7205,1467,0.169165129
CE,NOVA OLINDA,2022,12062,9990,2072,0.171779141
CE,NOVA RUSSAS,2022,25448,19014,6434,0.252829299
CE,NOVO ORIENTE,2022,23988,17705,6283,0.261922628
CE,OCARA,2022,23179,20011,3168,0.136675439
CE,ORÓS,2022,18976,13908,5068,0.267074199
CE,PACAJUS,2022,51296,44368,6928,0.135059264
CE,PACATUBA,2022,51651,44818,6833,0.132291727
CE,PACOTI,2022,10363,8521,1842,0.177747756
CE,PACUJÁ,2022,6398,4914,1484,0.231947484
CE,PALHANO,2022,8913,7580,1333,0.149556827
CE,PALMÁCIA,2022,9250,7700,1550,0.167567568
CE,PARACURU,2022,31171,26092,5079,0.162939912
CE,PARAIPABA,2022,25478,21848,3630,0.142475862
CE,PARAMBU,2022,28685,20528,8157,0.284364651
CE,PARAMOTI,2022,9801,8262,1539,0.157024793
CE,PEDRA BRANCA,2022,33697,26069,7628,0.2263703
CE,PENAFORTE,2022,8003,6726,1277,0.159565163
CE,PENTECOSTE,2022,31404,26543,4861,0.154789199
CE,PEREIRO,2022,15361,11276,4085,0.265933207
CE,PINDORETAMA,2022,18636,15845,2791,0.149763898
CE,PIQUET CARNEIRO,2022,11921,9721,2200,0.184548276
CE,PIRES FERREIRA,2022,8387,6762,1625,0.193752236
CE,PORANGA,2022,10533,7587,2946,0.279692395
CE,PORTEIRAS,2022,13894,10964,2930,0.210882395
CE,POTENGI,2022,7772,6060,1712,0.220277921
CE,POTIRETAMA,2022,5771,4904,867,0.150233928
CE,QUITERIANÓPOLIS,2022,17441,13274,4167,0.238919787
CE,QUIXADÁ,2022,58649,49074,9575,0.163259391
CE,QUIXELÔ,2022,14193,12308,1885,0.13281195
CE,QUIXERAMOBIM,2022,60071,47608,12463,0.207471159
CE,QUIXERÉ,2022,17644,14865,2779,0.157503967
CE,REDENÇÃO,2022,23131,19319,3812,0.164800484
CE,RERIUTABA,2022,16813,12592,4221,0.251055731
CE,RUSSAS,2022,56412,47851,8561,0.151758491
CE,SABOEIRO,2022,13100,9540,3560,0.271755725
CE,SALITRE,2022,14201,11031,3170,0.223223717
CE,SANTA QUITÉRIA,2022,33128,27258,5870,0.1771915
CE,SANTANA DO ACARAÚ,2022,25886,21052,4834,0.186741868
CE,SANTANA DO CARIRI,2022,13171,10882,2289,0.173790904
CE,SENADOR POMPEU,2022,21413,16822,4591,0.214402466
CE,SENADOR SÁ,2022,6704,5519,1185,0.176760143
CE,SOBRAL,2022,148145,125490,22655,0.1529245
CE,SOLONÓPOLE,2022,14895,11623,3272,0.219671031
CE,SÃO BENEDITO,2022,36308,28751,7557,0.208135948
CE,SÃO GONÇALO DO AMARANTE,2022,45801,38877,6924,0.151175739
CE,SÃO JOÃO DO JAGUARIBE,2022,6627,4923,1704,0.257129923
CE,SÃO LUÍS DO CURU,2022,11305,9341,1964,0.173728439
CE,TABULEIRO DO NORTE,2022,25991,20263,5728,0.220383979
CE,TAMBORIL,2022,22441,17046,5395,0.240408181
CE,TARRAFAS,2022,7767,5714,2053,0.26432342
CE,TAUÁ,2022,47620,36432,11188,0.234943301
CE,TEJUÇUOCA,2022,14859,12558,2301,0.154855643
CE,TIANGUÁ,2022,55305,47008,8297,0.150022602
CE,TRAIRI,2022,45199,37933,7266,0.160755769
CE,TURURU,2022,14299,12161,2138,0.149520946
CE,UBAJARA,2022,25122,20828,4294,0.170925882
CE,UMARI,2022,6460,4962,1498,0.231888545
CE,UMIRIM,2022,15246,12476,2770,0.181687
CE,URUBURETAMA,2022,17495,14824,2671,0.152672192
CE,URUOCA,2022,10806,9000,1806,0.167129373
CE,VARJOTA,2022,16794,12887,3907,0.23264261
CE,VIÇOSA DO CEARÁ,2022,45659,36818,8841,0.193631048
CE,VÁRZEA ALEGRE,2022,31399,25292,6107,0.19449664
DF,BRASÍLIA,2022,2203045,1816040,387005,0.175668223
ES,AFONSO CLÁUDIO,2022,25401,18673,6728,0.264871462
ES,ALEGRE,2022,23900,18491,5409,0.226317992
ES,ALFREDO CHAVES,2022,12515,9735,2780,0.22213344
ES,ALTO RIO NOVO,2022,6373,4571,1802,0.282755374
ES,ANCHIETA,2022,22626,18872,3754,0.165915319
ES,APIACÁ,2022,6194,4811,1383,0.223280594
ES,ARACRUZ,2022,72346,55933,16413,0.226868106
ES,ATÍLIO VIVÁCQUA,2022,8879,7208,1671,0.188196869
ES,BAIXO GUANDU,2022,23986,18681,5305,0.221170683
ES,BARRA DE SÃO FRANCISCO,2022,33841,24478,9363,0.276676221
ES,BOA ESPERANÇA,2022,10756,8533,2223,0.206675344
ES,BOM JESUS DO NORTE,2022,7454,6139,1315,0.176415347
ES,BREJETUBA,2022,10219,7528,2691,0.263333007
ES,CACHOEIRO DE ITAPEMIRIM,2022,141644,112279,29365,0.207315523
ES,CARIACICA,2022,272688,217791,54897,0.20131799
ES,CASTELO,2022,29404,23319,6085,0.206944633
ES,COLATINA,2022,92623,72236,20387,0.220107317
ES,CONCEIÇÃO DA BARRA,2022,23731,16750,6981,0.29417218
ES,CONCEIÇÃO DO CASTELO,2022,10318,7652,2666,0.258383408
ES,DIVINO DE SÃO LOURENÇO,2022,4312,3463,849,0.196892393
ES,DOMINGOS MARTINS,2022,28582,23528,5054,0.176824575
ES,DORES DO RIO PRETO,2022,6156,4846,1310,0.21280052
ES,ECOPORANGA,2022,19294,14322,4972,0.257696693
ES,FUNDÃO,2022,14217,11256,2961,0.208271787
ES,GOVERNADOR LINDENBERG,2022,8816,6814,2002,0.227087114
ES,GUARAPARI,2022,96661,74924,21737,0.2248787
ES,GUAÇUÍ,2022,21836,16510,5326,0.243909141
ES,IBATIBA,2022,18441,14907,3534,0.191638197
ES,IBIRAÇU,2022,9716,7643,2073,0.213359407
ES,IBITIRAMA,2022,6965,5738,1227,0.176166547
ES,ICONHA,2022,11339,9187,2152,0.189787459
ES,IRUPI,2022,11108,8419,2689,0.242077782
ES,ITAGUAÇU,2022,11688,8965,2723,0.23297399
ES,ITAPEMIRIM,2022,35442,28174,7268,0.205067434
ES,ITARANA,2022,9457,7499,1958,0.207042402
ES,IÚNA,2022,20793,16072,4721,0.227047564
ES,JAGUARÉ,2022,22488,17557,4931,0.219272501
ES,JERÔNIMO MONTEIRO,2022,9977,7773,2204,0.220908089
ES,JOÃO NEIVA,2022,12845,10237,2608,0.203036201
ES,LARANJA DA TERRA,2022,9218,7667,1551,0.168257757
ES,LINHARES,2022,118268,90853,27415,0.231804038
ES,MANTENÓPOLIS,2022,10960,7557,3403,0.310492701
ES,MARATAÍZES,2022,31322,24409,6913,0.22070749
ES,MARECHAL FLORIANO,2022,13430,10990,2440,0.1816828
ES,MARILÂNDIA,2022,10437,8714,1723,0.165085753
ES,MIMOSO DO SUL,2022,19587,16119,3468,0.177056211
ES,MONTANHA,2022,14959,11150,3809,0.25462932
ES,MUCURICI,2022,5093,3946,1147,0.225211074
ES,MUNIZ FREIRE,2022,14383,11098,3285,0.228394633
ES,MUQUI,2022,11052,9099,1953,0.176710098
ES,NOVA VENÉCIA,2022,39712,29882,9830,0.247532232
ES,PANCAS,2022,16165,11363,4802,0.297061553
ES,PEDRO CANÁRIO,2022,18575,13244,5331,0.286998654
ES,PINHEIROS,2022,18029,13877,4152,0.230295635
ES,PIÚMA,2022,17051,13288,3763,0.220690869
ES,PONTO BELO,2022,6419,4824,1595,0.248481072
ES,PRESIDENTE KENNEDY,2022,12277,9853,2424,0.197442372
ES,RIO BANANAL,2022,15346,11811,3535,0.230353186
ES,RIO NOVO DO SUL,2022,8685,7359,1326,0.152677029
ES,SANTA LEOPOLDINA,2022,10055,8074,1981,0.19701641
ES,SANTA MARIA DE JETIBÁ,2022,30247,24967,5280,0.174562767
ES,SANTA TERESA,2022,20198,15597,4601,0.227794831
ES,SERRA,2022,349398,278036,71362,0.204242726
ES,SOORETAMA,2022,20152,15056,5096,0.252878126
ES,SÃO DOMINGOS DO NORTE,2022,7595,6243,1352,0.17801185
ES,SÃO GABRIEL DA PALHA,2022,25586,19642,5944,0.232314547
ES,SÃO JOSÉ DO CALÇADO,2022,8642,6982,1660,0.192085165
ES,SÃO MATEUS,2022,88485,67054,21431,0.242199243
ES,SÃO ROQUE DO CANAÃ,2022,9534,7796,1738,0.182294944
ES,VARGEM ALTA,2022,15725,12560,3165,0.20127186
ES,VENDA NOVA DO IMIGRANTE,2022,19086,14686,4400,0.230535471
ES,VIANA,2022,51322,41937,9385,0.182865048
ES,VILA PAVÃO,2022,7345,6145,1200,0.163376447
ES,VILA VALÉRIO,2022,12419,10092,2327,0.187374185
ES,VILA VELHA,2022,336050,277498,58552,0.174235977
ES,VITÓRIA,2022,264428,219420,45008,0.170208904
ES,ÁGUA DOCE DO NORTE,2022,10652,7928,2724,0.255726624
ES,ÁGUIA BRANCA,2022,8588,6740,1848,0.215183978
GO,ABADIA DE GOIÁS,2022,12229,9268,2961,0.242129365
GO,ABADIÂNIA,2022,10831,8686,2145,0.198042655
GO,ACREÚNA,2022,15186,11834,3352,0.220729619
GO,ADELÂNDIA,2022,2796,2232,564,0.201716738
GO,ALEXÂNIA,2022,20212,16150,4062,0.200969721
GO,ALOÂNDIA,2022,2068,1688,380,0.183752418
GO,ALTO HORIZONTE,2022,6191,4583,1608,0.259731869
GO,ALTO PARAÍSO DE GOIÁS,2022,6997,5346,1651,0.235958268
GO,ALVORADA DO NORTE,2022,6703,5123,1580,0.235715351
GO,AMARALINA,2022,3093,2416,677,0.218881345
GO,AMERICANO DO BRASIL,2022,5200,4179,1021,0.196346154
GO,AMORINÓPOLIS,2022,3591,2892,699,0.1946533
GO,ANHANGÜERA,2022,1234,907,327,0.264991896
GO,ANICUNS,2022,15005,12193,2812,0.187404199
GO,ANÁPOLIS,2022,286671,221533,65138,0.227222147
GO,APARECIDA DE GOIÂNIA,2022,334859,262941,71918,0.214770993
GO,APARECIDA DO RIO DOCE,2022,2914,2226,688,0.236101579
GO,APORÉ,2022,3190,2325,865,0.271159875
GO,ARAGARÇAS,2022,13527,10343,3184,0.23538109
GO,ARAGOIÂNIA,2022,8754,6904,1850,0.211331963
GO,ARAGUAPAZ,2022,6051,4617,1434,0.236985622
GO,ARAÇU,2022,4008,3337,671,0.16741517
GO,ARENÓPOLIS,2022,3310,2656,654,0.197583082
GO,ARUANÃ,2022,7096,4825,2271,0.320039459
GO,AURILÂNDIA,2022,3207,2452,755,0.235422513
GO,AVELINÓPOLIS,2022,3333,2745,588,0.176417642
GO,BALIZA,2022,2871,2175,696,0.242424242
GO,BARRO ALTO,2022,9616,7319,2297,0.238872712
GO,BELA VISTA DE GOIÁS,2022,23292,17518,5774,0.247896273
GO,BOM JARDIM DE GOIÁS,2022,6961,5390,1571,0.225685965
GO,BOM JESUS DE GOIÁS,2022,17578,13076,4502,0.256115599
GO,BONFINÓPOLIS,2022,6725,5528,1197,0.177992565
GO,BONÓPOLIS,2022,3302,2516,786,0.238037553
GO,BRAZABRANTES,2022,3537,2718,819,0.231552163
GO,BRITÂNIA,2022,4762,3708,1054,0.221335573
GO,BURITI ALEGRE,2022,8417,6196,2221,0.263870738
GO,BURITI DE GOIÁS,2022,3317,2640,677,0.20410009
GO,BURITINÓPOLIS,2022,3434,2475,959,0.279266162
GO,CABECEIRAS,2022,6822,5364,1458,0.213720317
GO,CACHOEIRA ALTA,2022,8260,6085,2175,0.263317191
GO,CACHOEIRA DE GOIÁS,2022,1884,1429,455,0.241507431
GO,CACHOEIRA DOURADA,2022,7126,5442,1684,0.23631771
GO,CAIAPÔNIA,2022,13208,9858,3350,0.253634161
GO,CALDAS NOVAS,2022,65613,49393,16220,0.247207108
GO,CALDAZINHA,2022,3298,2561,737,0.223468769
GO,CAMPESTRE DE GOIÁS,2022,3731,2873,858,0.229965157
GO,CAMPINAÇU,2022,3507,2737,770,0.219560878
GO,CAMPINORTE,2022,9153,6916,2237,0.244400743
GO,CAMPO ALEGRE DE GOIÁS,2022,5282,4166,1116,0.211283605
GO,CAMPO LIMPO DE GOIÁS,2022,6124,4833,1291,0.210809928
GO,CAMPOS BELOS,2022,14197,10879,3318,0.233711347
GO,CAMPOS VERDES,2022,4043,3121,922,0.228048479
GO,CARMO DO RIO VERDE,2022,7075,5592,1483,0.209611307
GO,CASTELÂNDIA,2022,3665,2669,996,0.271759891
GO,CATALÃO,2022,74399,57901,16498,0.221750292
GO,CATURAÍ,2022,4783,3793,990,0.206983065
GO,CAVALCANTE,2022,7243,5415,1828,0.25238161
GO,CAÇU,2022,10886,8199,2687,0.246830792
GO,CERES,2022,16360,13576,2784,0.170171149
GO,CEZARINA,2022,7027,5635,1392,0.19809307
GO,CHAPADÃO DO CÉU,2022,8139,6360,1779,0.218577221
GO,CIDADE OCIDENTAL,2022,43652,35413,8239,0.188742784
GO,COCALZINHO DE GOIÁS,2022,15914,12267,3647,0.229169285
GO,COLINAS DO SUL,2022,3452,2553,899,0.260428737
GO,CORUMBAÍBA,2022,6835,5289,1546,0.226188734
GO,CORUMBÁ DE GOIÁS,2022,7527,5780,1747,0.232097781
GO,CRISTALINA,2022,35530,26865,8665,0.243878413
GO,CRISTIANÓPOLIS,2022,3899,2953,946,0.242626314
GO,CRIXÁS,2022,12552,9421,3131,0.24944232
GO,CROMÍNIA,2022,3667,3053,614,0.167439324
GO,CUMARI,2022,2575,1976,599,0.232621359
GO,CÓRREGO DO OURO,2022,2960,2355,605,0.204391892
GO,DAMIANÓPOLIS,2022,3799,2837,962,0.253224533
GO,DAMOLÂNDIA,2022,3458,2803,655,0.189415847
GO,DAVINÓPOLIS,2022,3593,2689,904,0.251600334
GO,DIORAMA,2022,2290,1853,437,0.190829694
GO,DIVINÓPOLIS DE GOIÁS,2022,4832,3612,1220,0.252483444
GO,DOVERLÂNDIA,2022,5755,4524,1231,0.213900956
GO,EDEALINA,2022,3988,3021,967,0.242477432
GO,EDÉIA,2022,9629,7478,2151,0.223387683
GO,ESTRELA DO NORTE,2022,2956,2368,588,0.198917456
GO,FAINA,2022,6180,4766,1414,0.228802589
GO,FAZENDA NOVA,2022,5215,4312,903,0.173154362
GO,FIRMINÓPOLIS,2022,8333,6628,1705,0.204608184
GO,FLORES DE GOIÁS,2022,6998,5122,1876,0.268076593
GO,FORMOSA,2022,75027,59376,15651,0.208604902
GO,FORMOSO,2022,4566,3507,1059,0.231931669
GO,GAMELEIRA DE GOIÁS,2022,3165,2631,534,0.168720379
GO,GOIANDIRA,2022,4259,3526,733,0.172106128
GO,GOIANIRA,2022,41108,30965,10143,0.246740294
GO,GOIANÁPOLIS,2022,10434,8209,2225,0.21324516
GO,GOIANÉSIA,2022,57111,43763,13348,0.233720299
GO,GOIATUBA,2022,26772,21226,5546,0.207156731
GO,GOIÁS,2022,19618,14823,4795,0.244418391
GO,GOIÂNIA,2022,1032004,819855,212149,0.20556994
GO,GOUVELÂNDIA,2022,3680,2990,690,0.1875
GO,GUAPÓ,2022,13799,10490,3309,0.239799986
GO,GUARANI DE GOIÁS,2022,4161,3423,738,0.177361211
GO,GUARAÍTA,2022,2635,2193,442,0.167741935
GO,GUARINOS,2022,2334,1875,459,0.196658098
GO,HEITORAÍ,2022,3972,3131,841,0.211732125
GO,HIDROLINA,2022,3602,3028,574,0.159355913
GO,HIDROLÂNDIA,2022,18752,14670,4082,0.217683447
GO,IACIARA,2022,7806,6096,1710,0.21906226
GO,INACIOLÂNDIA,2022,4634,3663,971,0.209538196
GO,INDIARA,2022,11729,9030,2699,0.230113394
GO,INHUMAS,2022,41069,31966,9103,0.221651367
GO,IPAMERI,2022,20230,15506,4724,0.233514582
GO,IPIRANGA DE GOIÁS,2022,3045,2491,554,0.181937603
GO,IPORÁ,2022,25860,19853,6007,0.23228925
GO,ISRAELÂNDIA,2022,2799,2140,659,0.235441229
GO,ITABERAÍ,2022,31867,24414,7453,0.233878307
GO,ITAGUARI,2022,4808,4001,807,0.167845258
GO,ITAGUARU,2022,5260,4384,876,0.166539924
GO,ITAJÁ,2022,3658,2851,807,0.220612356
GO,ITAPACI,2022,15440,11876,3564,0.230829016
GO,ITAPIRAPUÃ,2022,6721,5193,1528,0.227347121
GO,ITAPURANGA,2022,21640,17616,4024,0.185951941
GO,ITARUMÃ,2022,4385,3364,1021,0.232839225
GO,ITAUÇU,2022,7109,5964,1145,0.161063441
GO,ITUMBIARA,2022,74512,56767,17745,0.23814956
GO,IVOLÂNDIA,2022,2783,2142,641,0.230326985
GO,JANDAIA,2022,5976,4717,1259,0.210676037
GO,JARAGUÁ,2022,32246,25985,6261,0.194163617
GO,JATAÍ,2022,71896,54591,17305,0.240694893
GO,JAUPACI,2022,2739,2150,589,0.215041986
GO,JESÚPOLIS,2022,2485,1926,559,0.224949698
GO,JOVIÂNIA,2022,5464,4451,1013,0.185395315
GO,JUSSARA,2022,14484,11229,3255,0.224730737
GO,LAGOA SANTA,2022,1601,1147,454,0.283572767
GO,LEOPOLDO DE BULHÕES,2022,6628,5201,1427,0.215298733
GO,LUZIÂNIA,2022,125775,99917,25858,0.205589346
GO,MAIRIPOTABA,2022,2692,2141,551,0.204680535
GO,MAMBAÍ,2022,5963,4608,1355,0.227234613
GO,MARA ROSA,2022,8237,6421,1816,0.220468617
GO,MARZAGÃO,2022,2570,2010,560,0.217898833
GO,MATRINCHÃ,2022,3712,2959,753,0.202855603
GO,MAURILÂNDIA,2022,7022,5394,1628,0.23184278
GO,MIMOSO DE GOIÁS,2022,3023,2525,498,0.164737016
GO,MINAÇU,2022,22527,16736,5791,0.257069295
GO,MINEIROS,2022,47835,36670,11165,0.233406502
GO,MOIPORÁ,2022,2279,1770,509,0.223343572
GO,MONTE ALEGRE DE GOIÁS,2022,5550,4179,1371,0.247027027
GO,MONTES CLAROS DE GOIÁS,2022,6719,5261,1458,0.216996577
GO,MONTIVIDIU,2022,9468,7373,2095,0.221271652
GO,MONTIVIDIU DO NORTE,2022,3524,2729,795,0.225595914
GO,MORRINHOS,2022,36278,27771,8507,0.234494735
GO,MORRO AGUDO DE GOIÁS,2022,2855,2373,482,0.16882662
GO,MOSSÂMEDES,2022,4584,3695,889,0.193935428
GO,MOZARLÂNDIA,2022,12396,8878,3518,0.283801226
GO,MUNDO NOVO,2022,4868,3721,1147,0.235620378
GO,MUTUNÓPOLIS,2022,3410,2633,777,0.227859238
GO,NAZÁRIO,2022,7285,5693,1592,0.218531229
GO,NERÓPOLIS,2022,24019,18109,5910,0.246055206
GO,NIQUELÂNDIA,2022,27555,20708,6847,0.248484848
GO,NOVA AMÉRICA,2022,2472,2057,415,0.167880259
GO,NOVA AURORA,2022,2108,1762,346,0.164136622
GO,NOVA CRIXÁS,2022,9084,6650,2434,0.267943637
GO,NOVA GLÓRIA,2022,6665,5391,1274,0.191147787
GO,NOVA IGUAÇU DE GOIÁS,2022,2803,2082,721,0.257224402
GO,NOVA ROMA,2022,2829,2144,685,0.24213503
GO,NOVA VENEZA,2022,7946,6237,1709,0.215076768
GO,NOVO BRASIL,2022,3308,2713,595,0.179866989
GO,NOVO GAMA,2022,49426,40443,8983,0.181746449
GO,NOVO PLANALTO,2022,3705,2841,864,0.233198381
GO,ORIZONA,2022,11941,9409,2532,0.212042543
GO,OURO VERDE DE GOIÁS,2022,3741,3025,716,0.191392676
GO,OUVIDOR,2022,8700,6964,1736,0.19954023
GO,PADRE BERNARDO,2022,18811,14544,4267,0.226835362
GO,PALESTINA DE GOIÁS,2022,3573,2781,792,0.221662469
GO,PALMEIRAS DE GOIÁS,2022,21968,16930,5038,0.229333576
GO,PALMELO,2022,2199,1805,394,0.179172351
GO,PALMINÓPOLIS,2022,4078,3280,798,0.195684159
GO,PANAMÁ,2022,2608,1961,647,0.248082822
GO,PARANAIGUARA,2022,7024,5415,1609,0.229071754
GO,PARAÚNA,2022,8981,6621,2360,0.262776974
GO,PEROLÂNDIA,2022,3076,2340,736,0.239271782
GO,PETROLINA DE GOIÁS,2022,7398,5738,1660,0.224384969
GO,PILAR DE GOIÁS,2022,3669,2847,822,0.224039248
GO,PIRACANJUBA,2022,18894,14080,4814,0.25478988
GO,PIRANHAS,2022,9311,7257,2054,0.220599291
GO,PIRENÓPOLIS,2022,19985,15811,4174,0.208856642
GO,PIRES DO RIO,2022,21791,16634,5157,0.236657336
GO,PLANALTINA,2022,61018,47412,13606,0.222983382
GO,PONTALINA,2022,14230,11398,2832,0.199016163
GO,PORANGATU,2022,31009,23754,7255,0.233964333
GO,PORTEIRÃO,2022,3620,2670,950,0.262430939
GO,PORTELÂNDIA,2022,3156,2460,696,0.220532319
GO,POSSE,2022,24385,19240,5145,0.210990363
GO,PROFESSOR JAMIL,2022,3039,2392,647,0.21289898
GO,QUIRINÓPOLIS,2022,34503,27066,7437,0.215546474
GO,RIALMA,2022,8956,7051,1905,0.212706565
GO,RIANÁPOLIS,2022,3816,3077,739,0.193658281
GO,RIO QUENTE,2022,3939,3023,916,0.232546332
GO,RIO VERDE,2022,142441,112068,30373,0.213232145
GO,RUBIATABA,2022,15267,12095,3172,0.207768389
GO,SANCLERLÂNDIA,2022,7053,5612,1441,0.204310223
GO,SANTA BÁRBARA DE GOIÁS,2022,5371,4256,1115,0.207596351
GO,SANTA CRUZ DE GOIÁS,2022,3217,2514,703,0.218526578
GO,SANTA FÉ DE GOIÁS,2022,4056,3064,992,0.244575937
GO,SANTA HELENA DE GOIÁS,2022,29477,23311,6166,0.209180039
GO,SANTA ISABEL,2022,3706,2949,757,0.204263357
GO,SANTA RITA DO ARAGUAIA,2022,4430,3264,1166,0.263205418
GO,SANTA RITA DO NOVO DESTINO,2022,2768,2215,553,0.199783237
GO,SANTA ROSA DE GOIÁS,2022,3096,2606,490,0.158268734
GO,SANTA TEREZA DE GOIÁS,2022,3179,2394,785,0.246932998
GO,SANTA TEREZINHA DE GOIÁS,2022,7621,5980,1641,0.215326073
GO,SANTO ANTÔNIO DA BARRA,2022,4005,3159,846,0.211235955
GO,SANTO ANTÔNIO DE GOIÁS,2022,6203,4928,1275,0.205545704
GO,SANTO ANTÔNIO DO DESCOBERTO,2022,43084,34037,9047,0.209985145
GO,SENADOR CANEDO,2022,83963,66666,17297,0.206007408
GO,SERRANÓPOLIS,2022,6282,4692,1590,0.253104107
GO,SILVÂNIA,2022,15622,12556,3066,0.196261682
GO,SIMOLÂNDIA,2022,5727,4251,1476,0.257726558
GO,SÃO DOMINGOS,2022,7119,5257,1862,0.261553589
GO,SÃO FRANCISCO DE GOIÁS,2022,4706,3798,908,0.192945176
GO,SÃO JOÃO D'ALIANÇA,2022,7040,5481,1559,0.221448864
GO,SÃO JOÃO DA PARAÚNA,2022,2225,1690,535,0.240449438
GO,SÃO LUIZ DO NORTE,2022,4775,3659,1116,0.233717277
GO,SÃO LUÍS DE MONTES BELOS,2022,24067,18754,5313,0.220758715
GO,SÃO MIGUEL DO ARAGUAIA,2022,18361,13773,4588,0.249877458
GO,SÃO MIGUEL DO PASSA QUATRO,2022,3463,2904,559,0.161420733
GO,SÃO PATRÍCIO,2022,2347,1892,455,0.193864508
GO,SÃO SIMÃO,2022,13838,10344,3494,0.252493135
GO,SÍTIO D'ABADIA,2022,3164,2165,999,0.31573957
GO,TAQUARAL DE GOIÁS,2022,4559,3502,1057,0.23184909
GO,TERESINA DE GOIÁS,2022,2731,1981,750,0.27462468
GO,TEREZÓPOLIS DE GOIÁS,2022,6251,5130,1121,0.179331307
GO,TRINDADE,2022,89447,69775,19672,0.21992912
GO,TROMBAS,2022,3003,2235,768,0.255744256
GO,TRÊS RANCHOS,2022,3608,2815,793,0.219789357
GO,TURVELÂNDIA,2022,4081,3171,910,0.222984563
GO,TURVÂNIA,2022,4730,3753,977,0.206553911
GO,UIRAPURU,2022,2671,2081,590,0.220891052
GO,URUANA,2022,10411,8343,2068,0.198636058
GO,URUAÇU,2022,29135,22351,6784,0.232847091
GO,URUTAÍ,2022,3401,2717,684,0.201117318
GO,VALPARAÍSO DE GOIÁS,2022,89403,72838,16565,0.18528461
GO,VARJÃO,2022,3839,2916,923,0.240427195
GO,VIANÓPOLIS,2022,10663,8557,2106,0.197505392
GO,VICENTINÓPOLIS,2022,6305,5187,1118,0.177319588
GO,VILA BOA,2022,3801,2787,1014,0.266771902
GO,VILA PROPÍCIO,2022,5192,3989,1203,0.231702619
GO,ÁGUA FRIA DE GOIÁS,2022,4631,3491,1140,0.246167135
GO,ÁGUA LIMPA,2022,2298,1833,465,0.202349869
GO,ÁGUAS LINDAS DE GOIÁS,2022,107255,86486,20769,0.193641322
MA,AFONSO CUNHA,2022,7139,5438,1701,0.238268665
MA,ALCÂNTARA,2022,18188,13358,4830,0.26555971
MA,ALDEIAS ALTAS,2022,19442,13685,5757,0.296111511
MA,ALTAMIRA DO MARANHÃO,2022,5734,4031,1703,0.297000349
MA,ALTO ALEGRE DO MARANHÃO,2022,19349,13799,5550,0.286836529
MA,ALTO ALEGRE DO PINDARÉ,2022,22854,15750,7104,0.310842741
MA,ALTO PARNAÍBA,2022,8401,6166,2235,0.266039757
MA,AMAPÁ DO MARANHÃO,2022,5883,4237,1646,0.279789223
MA,AMARANTE DO MARANHÃO,2022,27464,20490,6974,0.253932421
MA,ANAJATUBA,2022,18653,14832,3821,0.204846405
MA,ANAPURUS,2022,14254,11289,2965,0.208011786
MA,APICUM-AÇU,2022,13711,10344,3367,0.245569251
MA,ARAGUANÃ,2022,8468,5774,2694,0.318138876
MA,ARAIOSES,2022,34888,24822,10066,0.288523274
MA,ARAME,2022,22621,16508,6113,0.270235622
MA,ARARI,2022,24794,18124,6670,0.269016698
MA,AXIXÁ,2022,9736,8346,1390,0.142769104
MA,AÇAILÂNDIA,2022,75967,60268,15699,0.206655521
MA,BACABAL,2022,66354,53847,12507,0.188489013
MA,BACABEIRA,2022,14219,11925,2294,0.161333427
MA,BACURI,2022,14377,10309,4068,0.282951937
MA,BACURITUBA,2022,5348,3912,1436,0.268511593
MA,BALSAS,2022,64426,50600,13826,0.2146028
MA,BARRA DO CORDA,2022,60533,46900,13633,0.225215998
MA,BARREIRINHAS,2022,45854,38050,7804,0.17019235
MA,BARÃO DE GRAJAÚ,2022,15040,11410,3630,0.241356383
MA,BELA VISTA DO MARANHÃO,2022,10338,7462,2876,0.278196943
MA,BELÁGUA,2022,7015,5978,1037,0.147826087
MA,BENEDITO LEITE,2022,4157,3221,936,0.225162377
MA,BEQUIMÃO,2022,19272,14217,5055,0.262297634
MA,BERNARDO DO MEARIM,2022,5295,4063,1232,0.232672332
MA,BOA VISTA DO GURUPI,2022,6501,4772,1729,0.265959083
MA,BOM JARDIM,2022,28937,20051,8886,0.3070809
MA,BOM JESUS DAS SELVAS,2022,21320,15261,6059,0.284193246
MA,BOM LUGAR,2022,11062,8842,2220,0.200687037
MA,BREJO,2022,24350,19287,5063,0.207926078
MA,BREJO DE AREIA,2022,7808,5571,2237,0.286501025
MA,BURITI,2022,23066,16752,6314,0.273736235
MA,BURITI BRAVO,2022,18870,13085,5785,0.306571277
MA,BURITICUPU,2022,41253,32309,8944,0.216808475
MA,BURITIRANA,2022,11870,8930,2940,0.247683235
MA,CACHOEIRA GRANDE,2022,9133,6527,2606,0.285338881
MA,CAJAPIÓ,2022,9738,7207,2531,0.259909632
MA,CAJARI,2022,15652,12063,3589,0.22929977
MA,CAMPESTRE DO MARANHÃO,2022,10322,7467,2855,0.276593683
MA,CANTANHEDE,2022,14272,10144,4128,0.289237668
MA,CAPINZAL DO NORTE,2022,9162,6915,2247,0.245252128
MA,CAROLINA,2022,18875,13929,4946,0.262039735
MA,CARUTAPERA,2022,19099,14168,4931,0.258181057
MA,CAXIAS,2022,108413,86953,21460,0.197946741
MA,CEDRAL,2022,9477,6837,2640,0.278569167
MA,CENTRAL DO MARANHÃO,2022,8036,5509,2527,0.31445993
MA,CENTRO DO GUILHERME,2022,7702,5828,1874,0.243313425
MA,CENTRO NOVO DO MARANHÃO,2022,12458,9277,3181,0.255337935
MA,CHAPADINHA,2022,54834,44522,10312,0.188058504
MA,CIDELÂNDIA,2022,11591,8523,3068,0.26468812
MA,CODÓ,2022,78601,58337,20264,0.257808425
MA,COELHO NETO,2022,32159,24788,7371,0.229204888
MA,COLINAS,2022,27218,21425,5793,0.212837093
MA,CONCEIÇÃO DO LAGO-AÇU,2022,11984,8882,3102,0.258845127
MA,COROATÁ,2022,44819,33146,11673,0.260447578
MA,CURURUPU,2022,27642,19799,7843,0.283734896
MA,CÂNDIDO MENDES,2022,16522,11877,4645,0.281140298
MA,DAVINÓPOLIS,2022,12288,9050,3238,0.263509115
MA,DOM PEDRO,2022,18553,13995,4558,0.245674554
MA,DUQUE BACELAR,2022,10107,7418,2689,0.26605323
MA,ESPERANTINÓPOLIS,2022,14206,11090,3116,0.219343939
MA,ESTREITO,2022,22965,17960,5005,0.217940344
MA,FEIRA NOVA DO MARANHÃO,2022,6222,5027,1195,0.192060431
MA,FERNANDO FALCÃO,2022,8952,7383,1569,0.175268097
MA,FORMOSA DA SERRA NEGRA,2022,12754,10488,2266,0.177669751
MA,FORTALEZA DOS NOGUEIRAS,2022,10120,8152,1968,0.194466403
MA,FORTUNA,2022,13111,9484,3627,0.276637938
MA,GODOFREDO VIANA,2022,8903,6326,2577,0.289452993
MA,GONÇALVES DIAS,2022,13812,9646,4166,0.301621778
MA,GOVERNADOR ARCHER,2022,8696,6193,2503,0.287833487
MA,GOVERNADOR EDISON LOBÃO,2022,14956,11459,3497,0.233819203
MA,GOVERNADOR EUGÊNIO BARROS,2022,11845,8378,3467,0.292697341
MA,GOVERNADOR LUIZ ROCHA,2022,6606,4749,1857,0.281108084
MA,GOVERNADOR NEWTON BELLO,2022,8246,5769,2477,0.300388067
MA,GOVERNADOR NUNES FREIRE,2022,18174,12926,5248,0.288764169
MA,GRAJAÚ,2022,47448,38444,9004,0.189765638
MA,GRAÇA ARANHA,2022,6405,4814,1591,0.248399688
MA,GUIMARÃES,2022,9625,7229,2396,0.248935065
MA,HUMBERTO DE CAMPOS,2022,23822,17651,6171,0.25904626
MA,ICATU,2022,20942,17667,3275,0.156384299
MA,IGARAPÉ DO MEIO,2022,12208,8537,3671,0.300704456
MA,IGARAPÉ GRANDE,2022,8091,6822,1269,0.156840934
MA,IMPERATRIZ,2022,182605,147426,35179,0.192650804
MA,ITAIPAVA DO GRAJAÚ,2022,9900,7845,2055,0.207575758
MA,ITAPECURU MIRIM,2022,45174,35145,10029,0.222008235
MA,ITINGA DO MARANHÃO,2022,18470,13815,4655,0.252030319
MA,JATOBÁ,2022,7175,5210,1965,0.273867596
MA,JENIPAPO DOS VIEIRAS,2022,12544,9967,2577,0.205436862
MA,JOSELÂNDIA,2022,11792,9402,2390,0.202679783
MA,JOÃO LISBOA,2022,20449,16792,3657,0.178835151
MA,JUNCO DO MARANHÃO,2022,5071,3704,1367,0.269572077
MA,LAGO DA PEDRA,2022,32906,26256,6650,0.202090804
MA,LAGO DO JUNCO,2022,8588,6451,2137,0.248835585
MA,LAGO DOS RODRIGUES,2022,8509,6566,1943,0.228346457
MA,LAGO VERDE,2022,13089,9310,3779,0.288715715
MA,LAGOA DO MATO,2022,8807,6125,2682,0.304530487
MA,LAGOA GRANDE DO MARANHÃO,2022,9704,7305,2399,0.247217642
MA,LAJEADO NOVO,2022,5990,4957,1033,0.17245409
MA,LIMA CAMPOS,2022,11030,8400,2630,0.238440617
MA,LORETO,2022,8722,6590,2132,0.244439349
MA,LUÍS DOMINGUES,2022,6074,4480,1594,0.26243003
MA,MAGALHÃES DE ALMEIDA,2022,13667,9589,4078,0.298382966
MA,MARACAÇUMÉ,2022,14747,10954,3793,0.257204855
MA,MARAJÁ DO SENA,2022,6439,4689,1750,0.271781333
MA,MARANHÃOZINHO,2022,8221,6120,2101,0.255565016
MA,MATA ROMA,2022,14674,12288,2386,0.162600518
MA,MATINHA,2022,18964,15344,3620,0.190887998
MA,MATÕES,2022,25490,19334,6156,0.241506473
MA,MATÕES DO NORTE,2022,6373,5054,1319,0.206966892
MA,MILAGRES DO MARANHÃO,2022,6167,4641,1526,0.247446084
MA,MIRADOR,2022,15259,12332,2927,0.19182122
MA,MIRANDA DO NORTE,2022,17018,12489,4529,0.26612998
MA,MIRINZAL,2022,11094,8718,2376,0.214169822
MA,MONTES ALTOS,2022,7254,5989,1265,0.174386545
MA,MONÇÃO,2022,19806,14856,4950,0.249924265
MA,MORROS,2022,16649,12753,3896,0.234008049
MA,NINA RODRIGUES,2022,10103,7712,2391,0.236662378
MA,NOVA COLINAS,2022,4443,3555,888,0.199864956
MA,NOVA IORQUE,2022,3959,3092,867,0.218994696
MA,NOVA OLINDA DO MARANHÃO,2022,13604,9857,3747,0.275433696
MA,OLHO D'ÁGUA DAS CUNHÃS,2022,15714,11186,4528,0.288150694
MA,OLINDA NOVA DO MARANHÃO,2022,11463,7859,3604,0.314402861
MA,PALMEIRÂNDIA,2022,17314,12179,5135,0.296580802
MA,PARAIBANO,2022,14531,10960,3571,0.245750465
MA,PARNARAMA,2022,27597,18967,8630,0.31271515
MA,PASSAGEM FRANCA,2022,13694,10501,3193,0.233167811
MA,PASTOS BONS,2022,14630,11352,3278,0.22406015
MA,PAULINO NEVES,2022,15316,11332,3984,0.260120136
MA,PAULO RAMOS,2022,16108,12385,3723,0.23112739
MA,PAÇO DO LUMIAR,2022,74725,64090,10635,0.142321847
MA,PEDREIRAS,2022,30962,23061,7901,0.255183774
MA,PEDRO DO ROSÁRIO,2022,18881,13148,5733,0.303638578
MA,PENALVA,2022,28237,18960,9277,0.328540567
MA,PERI MIRIM,2022,12061,8661,3400,0.28190034
MA,PERITORÓ,2022,15900,12537,3363,0.211509434
MA,PINDARÉ-MIRIM,2022,25556,19474,6082,0.237987165
MA,PINHEIRO,2022,59841,46195,13646,0.228037633
MA,PIO XII,2022,20378,14596,5782,0.283737364
MA,PIRAPEMAS,2022,12568,9391,3177,0.25278485
MA,PORTO FRANCO,2022,17576,14139,3437,0.195550751
MA,PORTO RICO DO MARANHÃO,2022,7114,4984,2130,0.299409615
MA,POÇÃO DE PEDRAS,2022,14639,11455,3184,0.217501195
MA,PRESIDENTE DUTRA,2022,29754,24147,5607,0.188445251
MA,PRESIDENTE JUSCELINO,2022,10631,7542,3089,0.290565328
MA,PRESIDENTE MÉDICI,2022,5433,4085,1348,0.248113381
MA,PRESIDENTE SARNEY,2022,16045,10797,5248,0.327080087
MA,PRESIDENTE VARGAS,2022,10500,7823,2677,0.254952381
MA,PRIMEIRA CRUZ,2022,11220,8309,2911,0.259447415
MA,RAPOSA,2022,20532,17050,3482,0.169588934
MA,RIACHÃO,2022,16168,12516,3652,0.225878278
MA,RIBAMAR FIQUENE,2022,6775,5069,1706,0.251808118
MA,ROSÁRIO,2022,30265,24803,5462,0.180472493
MA,SAMBAÍBA,2022,5692,4410,1282,0.225228391
MA,SANTA FILOMENA DO MARANHÃO,2022,5701,4703,998,0.175057008
MA,SANTA HELENA,2022,23160,17150,6010,0.259499136
MA,SANTA INÊS,2022,58946,47156,11790,0.200013572
MA,SANTA LUZIA,2022,43022,33692,9330,0.21686579
MA,SANTA LUZIA DO PARUÁ,2022,17854,13141,4713,0.26397446
MA,SANTA QUITÉRIA DO MARANHÃO,2022,22337,15854,6483,0.290235931
MA,SANTA RITA,2022,24640,19281,5359,0.217491883
MA,SANTANA DO MARANHÃO,2022,8712,5965,2747,0.315312213
MA,SANTO AMARO DO MARANHÃO,2022,11496,9072,2424,0.21085595
MA,SANTO ANTÔNIO DOS LOPES,2022,14946,11728,3218,0.215308444
MA,SATUBINHA,2022,7219,5467,1752,0.242692894
MA,SENADOR ALEXANDRE COSTA,2022,8618,6085,2533,0.293919703
MA,SENADOR LA ROCQUE,2022,13002,9415,3587,0.275880634
MA,SERRANO DO MARANHÃO,2022,8988,6757,2231,0.248219849
MA,SUCUPIRA DO NORTE,2022,8823,6751,2072,0.234840757
MA,SUCUPIRA DO RIACHÃO,2022,4619,3448,1171,0.253518078
MA,SÃO BENEDITO DO RIO PRETO,2022,14436,11986,2450,0.169714602
MA,SÃO BENTO,2022,28576,20981,7595,0.265782475
MA,SÃO BERNARDO,2022,23134,16744,6390,0.276216824
MA,SÃO DOMINGOS DO AZEITÃO,2022,6322,5203,1119,0.177000949
MA,SÃO DOMINGOS DO MARANHÃO,2022,29399,21710,7689,0.261539508
MA,SÃO FRANCISCO DO BREJÃO,2022,8045,6176,1869,0.23231821
MA,SÃO FRANCISCO DO MARANHÃO,2022,9910,7156,2754,0.27790111
MA,SÃO FÉLIX DE BALSAS,2022,4216,3069,1147,0.272058824
MA,SÃO JOSÉ DE RIBAMAR,2022,115164,95159,20005,0.173708798
MA,SÃO JOSÉ DOS BASÍLIOS,2022,6275,4981,1294,0.206215139
MA,SÃO JOÃO BATISTA,2022,19677,14769,4908,0.249428267
MA,SÃO JOÃO DO CARÚ,2022,11055,7353,3702,0.334871099
MA,SÃO JOÃO DO PARAÍSO,2022,8760,6727,2033,0.232077626
MA,SÃO JOÃO DO SOTER,2022,13562,10531,3031,0.22349211
MA,SÃO JOÃO DOS PATOS,2022,20808,15271,5537,0.266099577
MA,SÃO LUÍS,2022,749873,630275,119598,0.159491007
MA,SÃO LUÍS GONZAGA DO MARANHÃO,2022,17225,12866,4359,0.253062409
MA,SÃO MATEUS DO MARANHÃO,2022,27687,21265,6422,0.231950013
MA,SÃO PEDRO DA ÁGUA BRANCA,2022,9988,7091,2897,0.290048058
MA,SÃO PEDRO DOS CRENTES,2022,4506,3646,860,0.190856636
MA,SÃO RAIMUNDO DAS MANGABEIRAS,2022,16095,11948,4147,0.257657658
MA,SÃO RAIMUNDO DO DOCA BEZERRA,2022,5579,3961,1618,0.290016132
MA,SÃO ROBERTO,2022,4797,3584,1213,0.252866375
MA,SÃO VICENTE FERRER,2022,16474,11775,4699,0.285237344
MA,SÍTIO NOVO,2022,13401,11419,1982,0.14789941
MA,TASSO FRAGOSO,2022,7110,5537,1573,0.221237693
MA,TIMBIRAS,2022,20553,14848,5705,0.27757505
MA,TIMON,2022,115629,97017,18612,0.16096308
MA,TRIZIDELA DO VALE,2022,16654,13361,3293,0.197730275
MA,TUFILÂNDIA,2022,5954,4460,1494,0.250923749
MA,TUNTUM,2022,27039,21555,5484,0.202818152
MA,TURIAÇU,2022,29128,21332,7796,0.267646251
MA,TURILÂNDIA,2022,16646,11081,5565,0.33431455
MA,TUTÓIA,2022,39046,30531,8515,0.218076115
MA,URBANO SANTOS,2022,23904,19337,4567,0.19105589
MA,VARGEM GRANDE,2022,31175,24160,7015,0.225020048
MA,VIANA,2022,38545,29804,8741,0.226773901
MA,VILA NOVA DOS MARTÍRIOS,2022,8634,6408,2226,0.257817929
MA,VITORINO FREIRE,2022,25323,18009,7314,0.288828338
MA,VITÓRIA DO MEARIM,2022,26802,18411,8391,0.313073651
MA,ZÉ DOCA,2022,31682,24586,7096,0.223975759
MA,ÁGUA DOCE DO MARANHÃO,2022,12201,8337,3864,0.316695353
MG,ABADIA DOS DOURADOS,2022,5717,4615,1102,0.19275844
MG,ABAETÉ,2022,18975,14235,4740,0.249802372
MG,ABRE CAMPO,2022,11479,9176,2303,0.200627232
MG,ACAIACA,2022,3538,2662,876,0.247597513
MG,AGUANIL,2022,4013,3175,838,0.208821331
MG,AIMORÉS,2022,19192,14176,5016,0.2613589
MG,AIURUOCA,2022,5176,3948,1228,0.237248841
MG,ALAGOA,2022,2478,1931,547,0.220742534
MG,ALBERTINA,2022,2981,2354,627,0.210332103
MG,ALFENAS,2022,61363,47153,14210,0.231572772
MG,ALFREDO VASCONCELOS,2022,5785,4907,878,0.151771824
MG,ALMENARA,2022,30543,22124,8419,0.275644174
MG,ALPERCATA,2022,6492,4587,1905,0.293438078
MG,ALPINÓPOLIS,2022,15797,12413,3384,0.214217889
MG,ALTEROSA,2022,12093,9670,2423,0.200363847
MG,ALTO CAPARAÓ,2022,4311,3640,671,0.155648341
MG,ALTO JEQUITIBÁ,2022,6991,5649,1342,0.191961093
MG,ALTO RIO DOCE,2022,10267,7576,2691,0.26210188
MG,ALVARENGA,2022,4240,3407,833,0.196462264
MG,ALVINÓPOLIS,2022,13109,10329,2780,0.212068045
MG,ALVORADA DE MINAS,2022,4386,3110,1276,0.290925673
MG,ALÉM PARAÍBA,2022,28064,21534,6530,0.23268244
MG,AMPARO DO SERRA,2022,4637,3642,995,0.214578391
MG,ANDRADAS,2022,30449,23675,6774,0.22247036
MG,ANDRELÂNDIA,2022,9982,7423,2559,0.256361451
MG,ANGELÂNDIA,2022,6728,4697,2031,0.301872771
MG,ANTÔNIO CARLOS,2022,9754,7776,1978,0.2027886
MG,ANTÔNIO DIAS,2022,8838,6764,2074,0.234668477
MG,ANTÔNIO PRADO DE MINAS,2022,1781,1521,260,0.145985401
MG,ARACITABA,2022,2486,2030,456,0.183427192
MG,ARAGUARI,2022,89352,69217,20135,0.225344704
MG,ARANTINA,2022,2731,2213,518,0.189674112
MG,ARAPONGA,2022,6796,5347,1449,0.213213655
MG,ARAPORÃ,2022,6418,5078,1340,0.208787784
MG,ARAPUÁ,2022,3232,2489,743,0.229888614
MG,ARAXÁ,2022,80064,63097,16967,0.211917966
MG,ARAÇAÍ,2022,2353,1976,377,0.160220994
MG,ARAÇUAÍ,2022,28118,19065,9053,0.321964578
MG,ARAÚJOS,2022,6457,5346,1111,0.172061329
MG,ARCEBURGO,2022,7374,5906,1468,0.199077841
MG,ARCOS,2022,32295,26098,6197,0.191887289
MG,AREADO,2022,11782,9228,2554,0.216771346
MG,ARGIRITA,2022,2933,2319,614,0.209341971
MG,ARICANDUVA,2022,4863,3466,1397,0.287271232
MG,ARINOS,2022,13886,9695,4191,0.301814777
MG,ASTOLFO DUTRA,2022,10826,8729,2097,0.193700351
MG,ATALÉIA,2022,11365,7704,3661,0.322129344
MG,AUGUSTO DE LIMA,2022,4322,2993,1329,0.307496529
MG,AÇUCENA,2022,8595,5590,3005,0.349621873
MG,BAEPENDI,2022,15511,12218,3293,0.212300948
MG,BALDIM,2022,7112,5574,1538,0.216254218
MG,BAMBUÍ,2022,19129,14536,4593,0.240106644
MG,BANDEIRA,2022,4558,3262,1296,0.284335235
MG,BANDEIRA DO SUL,2022,5266,4154,1112,0.21116597
MG,BARBACENA,2022,99574,80424,19150,0.19231928
MG,BARRA LONGA,2022,5782,4405,1377,0.238152888
MG,BARROSO,2022,17395,14045,3350,0.192584076
MG,BARÃO DE COCAIS,2022,24736,19792,4944,0.199870634
MG,BARÃO DE MONTE ALTO,2022,5511,4311,1200,0.217746326
MG,BELA VISTA DE MINAS,2022,7956,6538,1418,0.178230266
MG,BELMIRO BRAGA,2022,3007,2446,561,0.186564682
MG,BELO HORIZONTE,2022,2006854,1569591,437263,0.217884809
MG,BELO ORIENTE,2022,19831,14898,4933,0.248751954
MG,BELO VALE,2022,8019,6548,1471,0.183439332
MG,BERILO,2022,9077,5859,3218,0.354522419
MG,BERIZAL,2022,4005,3147,858,0.21423221
MG,BERTÓPOLIS,2022,4293,3106,1187,0.276496622
MG,BETIM,2022,290957,247373,43584,0.149795331
MG,BIAS FORTES,2022,3759,2954,805,0.2141527
MG,BICAS,2022,11663,8987,2676,0.229443539
MG,BIQUINHAS,2022,2470,1980,490,0.198380567
MG,BOA ESPERANÇA,2022,32303,24423,7880,0.243940191
MG,BOCAINA DE MINAS,2022,4467,3521,946,0.211775241
MG,BOCAIÚVA,2022,37215,28155,9060,0.243450222
MG,BOM DESPACHO,2022,38923,30118,8805,0.226215862
MG,BOM JARDIM DE MINAS,2022,5908,4651,1257,0.212762356
MG,BOM JESUS DA PENHA,2022,3531,2830,701,0.198527329
MG,BOM JESUS DO AMPARO,2022,5100,4028,1072,0.210196078
MG,BOM JESUS DO GALHO,2022,12440,9492,2948,0.236977492
MG,BOM REPOUSO,2022,8920,7524,1396,0.156502242
MG,BOM SUCESSO,2022,15529,11642,3887,0.250305879
MG,BONFIM,2022,7069,5571,1498,0.211911161
MG,BONFINÓPOLIS DE MINAS,2022,5046,3612,1434,0.284185493
MG,BONITO DE MINAS,2022,8240,5701,2539,0.308131068
MG,BORDA DA MATA,2022,13306,10391,2915,0.219074102
MG,BOTELHOS,2022,12905,9764,3141,0.243394033
MG,BOTUMIRIM,2022,5427,3840,1587,0.292426755
MG,BRASILÂNDIA DE MINAS,2022,11732,8984,2748,0.234231163
MG,BRASÍLIA DE MINAS,2022,27220,19553,7667,0.281667891
MG,BRAZÓPOLIS,2022,12766,9590,3176,0.248785837
MG,BRAÚNAS,2022,4417,3082,1335,0.30224134
MG,BRUMADINHO,2022,32326,26026,6300,0.194889563
MG,BRÁS PIRES,2022,4596,3259,1337,0.290905135
MG,BUENO BRANDÃO,2022,8908,6789,2119,0.237876066
MG,BUENÓPOLIS,2022,8483,5369,3114,0.367087115
MG,BUGRE,2022,4422,3224,1198,0.270918137
MG,BURITIS,2022,19057,14185,4872,0.25565409
MG,BURITIZEIRO,2022,19516,14350,5166,0.264705882
MG,CABECEIRA GRANDE,2022,5507,4117,1390,0.252406029
MG,CABO VERDE,2022,9590,7607,1983,0.206777894
MG,CACHOEIRA DA PRATA,2022,3537,2876,661,0.186881538
MG,CACHOEIRA DE MINAS,2022,9710,7851,1859,0.191452111
MG,CACHOEIRA DE PAJEÚ,2022,7133,5029,2104,0.294967055
MG,CACHOEIRA DOURADA,2022,2415,1886,529,0.219047619
MG,CAETANÓPOLIS,2022,8720,7029,1691,0.193922018
MG,CAETÉ,2022,34242,26972,7270,0.212312365
MG,CAIANA,2022,4142,3322,820,0.197971994
MG,CAJURI,2022,4581,3767,814,0.177690461
MG,CALDAS,2022,10973,8519,2454,0.223639843
MG,CAMACHO,2022,2994,2553,441,0.147294589
MG,CAMANDUCAIA,2022,18312,13860,4452,0.243119266
MG,CAMBUQUIRA,2022,10268,7819,2449,0.238507986
MG,CAMBUÍ,2022,21966,16783,5183,0.235955568
MG,CAMPANHA,2022,12537,9647,2890,0.230517668
MG,CAMPANÁRIO,2022,3389,2280,1109,0.327235173
MG,CAMPESTRE,2022,16841,13214,3627,0.215367258
MG,CAMPINA VERDE,2022,14762,11007,3755,0.254369327
MG,CAMPO AZUL,2022,4139,2862,1277,0.30852863
MG,CAMPO BELO,2022,39977,30342,9635,0.241013583
MG,CAMPO DO MEIO,2022,10111,7777,2334,0.230837702
MG,CAMPO FLORIDO,2022,6374,4973,1401,0.219799184
MG,CAMPOS ALTOS,2022,10479,7364,3115,0.297261189
MG,CAMPOS GERAIS,2022,20751,15683,5068,0.244229194
MG,CANA VERDE,2022,4772,3884,888,0.186085499
MG,CANAÃ,2022,4326,3588,738,0.170596394
MG,CANDEIAS,2022,12161,9317,2844,0.233862347
MG,CANTAGALO,2022,3763,2619,1144,0.304012756
MG,CANÁPOLIS,2022,8821,6658,2163,0.245210294
MG,CAPARAÓ,2022,4316,3424,892,0.206672845
MG,CAPELA NOVA,2022,4463,3710,753,0.168720592
MG,CAPELINHA,2022,29480,21711,7769,0.2635346
MG,CAPETINGA,2022,5717,4186,1531,0.267797796
MG,CAPIM BRANCO,2022,8150,6629,1521,0.186625767
MG,CAPINÓPOLIS,2022,11538,8929,2609,0.226122378
MG,CAPITÃO ANDRADE,2022,4081,2788,1293,0.316834109
MG,CAPITÃO ENÉAS,2022,12472,9422,3050,0.244547787
MG,CAPITÓLIO,2022,7862,6032,1830,0.2327652
MG,CAPUTIRA,2022,8083,6407,1676,0.207348757
MG,CARANAÍBA,2022,3208,2649,559,0.17425187
MG,CARANDAÍ,2022,20419,17180,3239,0.158626769
MG,CARANGOLA,2022,25353,18967,6386,0.251883406
MG,CARATINGA,2022,65233,48450,16783,0.257277758
MG,CARAÍ,2022,14999,9836,5163,0.344222948
MG,CARBONITA,2022,8012,5803,2209,0.275711433
MG,CAREAÇU,2022,5083,4014,1069,0.210308873
MG,CARLOS CHAGAS,2022,16606,11261,5345,0.321871613
MG,CARMO DA CACHOEIRA,2022,9608,7281,2327,0.242194005
MG,CARMO DA MATA,2022,9946,7890,2056,0.206716268
MG,CARMO DE MINAS,2022,10019,7876,2143,0.213893602
MG,CARMO DO CAJURU,2022,18681,15417,3264,0.174722981
MG,CARMO DO PARANAÍBA,2022,22807,16799,6008,0.263427895
MG,CARMO DO RIO CLARO,2022,15770,12344,3426,0.217247939
MG,CARMÉSIA,2022,2408,1805,603,0.250415282
MG,CARMÓPOLIS DE MINAS,2022,14147,11591,2556,0.180674348
MG,CARNEIRINHO,2022,7679,6114,1565,0.203802578
MG,CARRANCAS,2022,3495,2759,736,0.210586552
MG,CARVALHOS,2022,4040,3262,778,0.192574257
MG,CARVALHÓPOLIS,2022,3267,2668,599,0.183348638
MG,CASA GRANDE,2022,2547,2220,327,0.128386337
MG,CASCALHO RICO,2022,3522,2673,849,0.241056218
MG,CATAGUASES,2022,53820,41534,12286,0.22827945
MG,CATAS ALTAS,2022,4831,3914,917,0.189815773
MG,CATAS ALTAS DA NORUEGA,2022,3860,3027,833,0.215803109
MG,CATUJI,2022,8072,5747,2325,0.288032706
MG,CATUTI,2022,4411,3330,1081,0.245069145
MG,CAXAMBU,2022,18108,13141,4967,0.274298653
MG,CEDRO DO ABAETÉ,2022,1291,951,340,0.263361735
MG,CENTRAL DE MINAS,2022,5993,4216,1777,0.296512598
MG,CENTRALINA,2022,7360,5833,1527,0.207472826
MG,CHALÉ,2022,5237,4209,1028,0.196295589
MG,CHAPADA DO NORTE,2022,9393,5799,3594,0.382625359
MG,CHAPADA GAÚCHA,2022,8859,6517,2342,0.264363924
MG,CHIADOR,2022,2933,2413,520,0.177292874
MG,CHÁCARA,2022,3623,3080,543,0.149875794
MG,CIPOTÂNEA,2022,5789,3937,1852,0.319917084
MG,CLARAVAL,2022,4578,3665,913,0.199432066
MG,CLARO DOS POÇÕES,2022,7485,5895,1590,0.21242485
MG,CLÁUDIO,2022,21791,17912,3879,0.17800927
MG,COIMBRA,2022,6343,5304,1039,0.163802617
MG,COLUNA,2022,6839,4789,2050,0.299751426
MG,COMENDADOR GOMES,2022,2830,2106,724,0.255830389
MG,COMERCINHO,2022,6796,4702,2094,0.308122425
MG,CONCEIÇÃO DA APARECIDA,2022,8077,6441,1636,0.202550452
MG,CONCEIÇÃO DA BARRA DE MINAS,2022,3690,3075,615,0.166666667
MG,CONCEIÇÃO DAS ALAGOAS,2022,19641,15155,4486,0.228399776
MG,CONCEIÇÃO DAS PEDRAS,2022,2699,2180,519,0.192293442
MG,CONCEIÇÃO DE IPANEMA,2022,4205,3298,907,0.2156956
MG,CONCEIÇÃO DO MATO DENTRO,2022,18123,13309,4814,0.265629311
MG,CONCEIÇÃO DO PARÁ,2022,5117,4027,1090,0.213015439
MG,CONCEIÇÃO DO RIO VERDE,2022,10387,7987,2400,0.231058053
MG,CONCEIÇÃO DOS OUROS,2022,8628,7345,1283,0.148701901
MG,CONFINS,2022,6592,5565,1027,0.155794903
MG,CONGONHAL,2022,9337,7653,1684,0.180357717
MG,CONGONHAS,2022,42200,35171,7029,0.166563981
MG,CONGONHAS DO NORTE,2022,4227,2960,1267,0.299739768
MG,CONQUISTA,2022,5422,4400,1022,0.188491332
MG,CONSELHEIRO LAFAIETE,2022,97282,81251,16031,0.164788964
MG,CONSELHEIRO PENA,2022,16876,11815,5061,0.29989334
MG,CONSOLAÇÃO,2022,1923,1421,502,0.261050442
MG,CONTAGEM,2022,452185,379128,73057,0.161564404
MG,COQUEIRAL,2022,7747,5999,1748,0.22563573
MG,CORAÇÃO DE JESUS,2022,21237,15613,5624,0.264820832
MG,CORDISBURGO,2022,7189,5619,1570,0.218389206
MG,CORDISLÂNDIA,2022,2728,2147,581,0.21297654
MG,CORINTO,2022,20059,14092,5967,0.297472456
MG,COROACI,2022,7634,5806,1828,0.239455069
MG,COROMANDEL,2022,24122,18478,5644,0.233977282
MG,CORONEL FABRICIANO,2022,81861,62192,19669,0.240273146
MG,CORONEL MURTA,2022,7192,5396,1796,0.249721913
MG,CORONEL PACHECO,2022,2857,2350,507,0.177458873
MG,CORONEL XAVIER CHAVES,2022,2937,2422,515,0.175348996
MG,COUTO DE MAGALHÃES DE MINAS,2022,3866,2771,1095,0.283238489
MG,CRISTAIS,2022,8407,6673,1734,0.206256691
MG,CRISTIANO OTONI,2022,4426,3663,763,0.17239042
MG,CRISTINA,2022,8252,6358,1894,0.229520116
MG,CRISTÁLIA,2022,5147,3631,1516,0.294540509
MG,CRISÓLITA,2022,4809,3391,1418,0.294863797
MG,CRUCILÂNDIA,2022,5387,4200,1187,0.220345276
MG,CRUZEIRO DA FORTALEZA,2022,3901,3180,721,0.184824404
MG,CRUZÍLIA,2022,12982,10078,2904,0.223694346
MG,CUPARAQUE,2022,4257,2858,1399,0.328635189
MG,CURRAL DE DENTRO,2022,6375,4657,1718,0.269490196
MG,CURVELO,2022,60160,46031,14129,0.234857048
MG,CÁSSIA,2022,14341,10471,3870,0.269855659
MG,CÓRREGO DANTA,2022,3050,2281,769,0.252131148
MG,CÓRREGO DO BOM JESUS,2022,4132,3263,869,0.210309777
MG,CÓRREGO FUNDO,2022,5254,4296,958,0.182337267
MG,CÓRREGO NOVO,2022,3530,2681,849,0.240509915
MG,CÔNEGO MARINHO,2022,6179,4465,1714,0.277391164
MG,DATAS,2022,4999,3732,1267,0.25345069
MG,DELFIM MOREIRA,2022,6716,5324,1392,0.20726623
MG,DELFINÓPOLIS,2022,6199,4589,1610,0.25971931
MG,DELTA,2022,6872,5345,1527,0.222206054
MG,DESCOBERTO,2022,4468,3590,878,0.196508505
MG,DESTERRO DE ENTRE RIOS,2022,6127,4985,1142,0.186388118
MG,DESTERRO DO MELO,2022,3559,3051,508,0.142736724
MG,DIAMANTINA,2022,38097,28653,9444,0.247893535
MG,DIOGO DE VASCONCELOS,2022,3751,2991,760,0.202612637
MG,DIONÍSIO,2022,6954,4920,2034,0.292493529
MG,DIVINO,2022,15893,11821,4072,0.256213427
MG,DIVINO DAS LARANJEIRAS,2022,4699,3196,1503,0.319855288
MG,DIVINOLÂNDIA DE MINAS,2022,6451,4252,2199,0.340877383
MG,DIVINÉSIA,2022,4522,3657,865,0.191287041
MG,DIVINÓPOLIS,2022,170252,140227,30025,0.176356225
MG,DIVISA ALEGRE,2022,5271,3900,1371,0.260102447
MG,DIVISA NOVA,2022,4899,3880,1019,0.208001633
MG,DIVISÓPOLIS,2022,6877,5126,1751,0.254616839
MG,DOM BOSCO,2022,3570,2720,850,0.238095238
MG,DOM CAVATI,2022,4129,3346,783,0.189634294
MG,DOM JOAQUIM,2022,4037,3033,1004,0.248699529
MG,DOM SILVÉRIO,2022,4476,3480,996,0.222520107
MG,DOM VIÇOSO,2022,2880,2428,452,0.156944444
MG,DONA EUSÉBIA,2022,5628,4702,926,0.164534471
MG,DORES DE CAMPOS,2022,7823,6780,1043,0.133324811
MG,DORES DE GUANHÃES,2022,5140,3719,1421,0.276459144
MG,DORES DO INDAIÁ,2022,11337,8119,3218,0.283849343
MG,DORES DO TURVO,2022,5225,3994,1231,0.235598086
MG,DORESÓPOLIS,2022,2264,1558,706,0.311837456
MG,DOURADOQUARA,2022,1991,1643,348,0.174786539
MG,DURANDÉ,2022,6570,5046,1524,0.23196347
MG,ELÓI MENDES,2022,20005,16030,3975,0.198700325
MG,ENGENHEIRO CALDAS,2022,7826,5421,2405,0.30730897
MG,ENGENHEIRO NAVARRO,2022,6221,4574,1647,0.264748433
MG,ENTRE FOLHAS,2022,5877,4459,1418,0.241279564
MG,ENTRE RIOS DE MINAS,2022,12482,10037,2445,0.19588207
MG,ERVÁLIA,2022,15542,12982,2560,0.164714966
MG,ESMERALDAS,2022,52999,41263,11736,0.22143814
MG,ESPERA FELIZ,2022,17931,13917,4014,0.223858123
MG,ESPINOSA,2022,23348,18261,5087,0.217877334
MG,ESPÍRITO SANTO DO DOURADO,2022,5096,4147,949,0.18622449
MG,ESTIVA,2022,9267,7697,1570,0.169418366
MG,ESTRELA DALVA,2022,2777,2169,608,0.218941304
MG,ESTRELA DO INDAIÁ,2022,2945,2176,769,0.261120543
MG,ESTRELA DO SUL,2022,5766,4470,1296,0.224765869
MG,EUGENÓPOLIS,2022,9107,7266,1841,0.202152191
MG,EWBANK DA CÂMARA,2022,4260,3460,800,0.187793427
MG,EXTREMA,2022,37091,28352,8739,0.235609717
MG,FAMA,2022,3146,2375,771,0.245073109
MG,FARIA LEMOS,2022,3201,2554,647,0.202124336
MG,FELISBURGO,2022,5649,3842,1807,0.319879625
MG,FELIXLÂNDIA,2022,11840,8702,3138,0.265033784
MG,FELÍCIO DOS SANTOS,2022,5032,3344,1688,0.3354531
MG,FERNANDES TOURINHO,2022,2754,1936,818,0.297022513
MG,FERROS,2022,8669,6195,2474,0.285384704
MG,FERVEDOURO,2022,8006,6600,1406,0.175618286
MG,FLORESTAL,2022,6644,5298,1346,0.202588802
MG,FORMIGA,2022,54947,43190,11757,0.213969825
MG,FORMOSO,2022,5849,4482,1367,0.233715165
MG,FORTALEZA DE MINAS,2022,3299,2343,956,0.289784783
MG,FORTUNA DE MINAS,2022,2634,2272,362,0.137433561
MG,FRANCISCO BADARÓ,2022,7252,4628,2624,0.361831219
MG,FRANCISCO DUMONT,2022,4177,3116,1061,0.254010055
MG,FRANCISCO SÁ,2022,19577,14408,5169,0.264034326
MG,FRANCISCÓPOLIS,2022,5068,3396,1672,0.329913181
MG,FREI GASPAR,2022,5355,3909,1446,0.270028011
MG,FREI INOCÊNCIO,2022,6964,4940,2024,0.290637565
MG,FREI LAGONEGRO,2022,3527,2642,885,0.250921463
MG,FRONTEIRA,2022,10350,7918,2432,0.234975845
MG,FRONTEIRA DOS VALES,2022,3963,3070,893,0.225334343
MG,FRUTA DE LEITE,2022,5074,3196,1878,0.370122192
MG,FRUTAL,2022,41995,30962,11033,0.262721753
MG,FUNILÂNDIA,2022,4931,3886,1045,0.211924559
MG,GALILÉIA,2022,5477,3766,1711,0.312397298
MG,GAMELEIRAS,2022,4526,3514,1012,0.223596995
MG,GLAUCILÂNDIA,2022,3772,3118,654,0.173382821
MG,GOIABEIRA,2022,2899,2284,615,0.212142118
MG,GOIANÁ,2022,4133,3234,899,0.217517542
MG,GONZAGA,2022,4875,3133,1742,0.357333333
MG,GONÇALVES,2022,4018,3039,979,0.243653559
MG,GOUVEIA,2022,10588,7919,2669,0.252077824
MG,GOVERNADOR VALADARES,2022,215631,152998,62633,0.290463802
MG,GRUPIARA,2022,1648,1300,348,0.211165049
MG,GRÃO MOGOL,2022,11960,8372,3588,0.3
MG,GUANHÃES,2022,25164,17483,7681,0.305237641
MG,GUAPÉ,2022,10870,8310,2560,0.23551058
MG,GUARACIABA,2022,8278,6300,1978,0.238946605
MG,GUARACIAMA,2022,4909,3972,937,0.190873905
MG,GUARANI,2022,6986,5505,1481,0.211995419
MG,GUARANÉSIA,2022,15372,11763,3609,0.234777518
MG,GUARARÁ,2022,3555,2795,760,0.213783404
MG,GUARDA-MOR,2022,5929,4391,1538,0.259402935
MG,GUAXUPÉ,2022,38830,29912,8918,0.229667783
MG,GUIDOVAL,2022,6413,5269,1144,0.17838765
MG,GUIMARÂNIA,2022,6932,5346,1586,0.228793999
MG,GUIRICEMA,2022,7238,5958,1280,0.176844432
MG,GURINHATÃ,2022,5008,3628,1380,0.275559105
MG,HELIODORA,2022,5125,4196,929,0.181268293
MG,IAPU,2022,8555,6211,2344,0.273991818
MG,IBERTIOGA,2022,4989,3898,1091,0.218681098
MG,IBIAÍ,2022,6579,4490,2089,0.31752546
MG,IBIRACATU,2022,5950,4008,1942,0.326386555
MG,IBIRACI,2022,9122,7091,2031,0.222648542
MG,IBIRITÉ,2022,125531,101574,23957,0.190845289
MG,IBITIÚRA DE MINAS,2022,3327,2678,649,0.195070634
MG,IBITURUNA,2022,2569,2025,544,0.211755547
MG,IBIÁ,2022,17222,12683,4539,0.263558239
MG,ICARAÍ DE MINAS,2022,8456,6254,2202,0.260406812
MG,IGARAPÉ,2022,31911,25272,6639,0.208047382
MG,IGARATINGA,2022,8095,6562,1533,0.189376158
MG,IGUATAMA,2022,6469,5015,1454,0.22476426
MG,IJACI,2022,5399,4523,876,0.162252269
MG,ILICÍNEA,2022,9831,7782,2049,0.208422338
MG,IMBÉ DE MINAS,2022,5346,4258,1088,0.203516648
MG,INCONFIDENTES,2022,6369,5126,1243,0.195164076
MG,INDAIABIRA,2022,6283,4248,2035,0.323889862
MG,INDIANÓPOLIS,2022,4878,3927,951,0.19495695
MG,INGAÍ,2022,2478,2136,342,0.138014528
MG,INHAPIM,2022,20199,14996,5203,0.257587009
MG,INHAÚMA,2022,5731,4628,1103,0.192462049
MG,INIMUTABA,2022,6289,4799,1490,0.236921609
MG,IPABA,2022,14060,10071,3989,0.28371266
MG,IPANEMA,2022,15579,11433,4146,0.266127479
MG,IPATINGA,2022,179843,138346,41497,0.230740146
MG,IPIAÇU,2022,3699,2712,987,0.266828873
MG,IPUIÚNA,2022,7757,6301,1456,0.187701431
MG,IRAÍ DE MINAS,2022,6101,4997,1104,0.180953942
MG,ITABIRA,2022,91280,74867,16413,0.179809378
MG,ITABIRINHA,2022,8159,6275,1884,0.230910651
MG,ITABIRITO,2022,42938,34596,8342,0.194280125
MG,ITACAMBIRA,2022,4600,3533,1067,0.231956522
MG,ITACARAMBI,2022,13709,9381,4328,0.315705011
MG,ITAGUARA,2022,10858,8820,2038,0.187695708
MG,ITAIPÉ,2022,9296,6076,3220,0.346385542
MG,ITAJUBÁ,2022,73509,56980,16529,0.22485682
MG,ITAMARANDIBA,2022,25736,19326,6410,0.249067454
MG,ITAMARATI DE MINAS,2022,3650,2939,711,0.194794521
MG,ITAMBACURI,2022,18523,12292,6231,0.336392593
MG,ITAMBÉ DO MATO DENTRO,2022,2491,2018,473,0.189883581
MG,ITAMOGI,2022,9338,7134,2204,0.236024845
MG,ITAMONTE,2022,11959,9500,2459,0.205619199
MG,ITANHANDU,2022,12505,9944,2561,0.204798081
MG,ITANHOMI,2022,9673,6852,2821,0.291636514
MG,ITAOBIM,2022,16463,11704,4759,0.289072466
MG,ITAPAGIPE,2022,10303,7902,2401,0.233038921
MG,ITAPECERICA,2022,17900,14533,3367,0.188100559
MG,ITAPEVA,2022,8506,6469,2037,0.239478016
MG,ITATIAIUÇU,2022,10523,8340,2183,0.207450347
MG,ITAVERAVA,2022,5634,4658,976,0.173233937
MG,ITAÚ DE MINAS,2022,12350,9439,2911,0.235708502
MG,ITAÚNA,2022,71333,57321,14012,0.196430824
MG,ITINGA,2022,11302,7783,3519,0.311360821
MG,ITUETA,2022,4962,3759,1203,0.242442563
MG,ITUIUTABA,2022,77325,58644,18681,0.241590689
MG,ITUMIRIM,2022,6029,4755,1274,0.211311992
MG,ITURAMA,2022,30194,22705,7489,0.24802941
MG,ITUTINGA,2022,3756,2985,771,0.205271565
MG,JABOTICATUBAS,2022,15064,11952,3112,0.206585236
MG,JACINTO,2022,9253,6597,2656,0.28704204
MG,JACUTINGA,2022,18964,14602,4362,0.230014765
MG,JACUÍ,2022,6420,4705,1715,0.267133956
MG,JAGUARAÇU,2022,3146,2505,641,0.203750795
MG,JAMPRUCA,2022,4310,3071,1239,0.287470998
MG,JANAÚBA,2022,53098,40986,12112,0.22810652
MG,JANUÁRIA,2022,50661,35491,15170,0.299441385
MG,JAPARAÍBA,2022,3496,2930,566,0.161899314
MG,JAPONVAR,2022,8361,6096,2265,0.27090061
MG,JAÍBA,2022,25249,19266,5983,0.23695988
MG,JECEABA,2022,5990,4851,1139,0.19015025
MG,JENIPAPO DE MINAS,2022,5958,3717,2241,0.376132931
MG,JEQUERI,2022,10383,7729,2654,0.255610132
MG,JEQUITAÍ,2022,6674,4522,2152,0.32244531
MG,JEQUITIBÁ,2022,5805,4628,1177,0.202756245
MG,JEQUITINHONHA,2022,18232,12479,5753,0.315544098
MG,JESUÂNIA,2022,4259,3321,938,0.220239493
MG,JOANÉSIA,2022,5039,3575,1464,0.290533836
MG,JOAQUIM FELÍCIO,2022,3507,2482,1025,0.292272598
MG,JOAÍMA,2022,10931,7347,3584,0.327874851
MG,JORDÂNIA,2022,7705,5413,2292,0.297469176
MG,JOSENÓPOLIS,2022,3439,2248,1191,0.346321605
MG,JOSÉ GONÇALVES DE MINAS,2022,3802,2631,1171,0.307995792
MG,JOSÉ RAYDAN,2022,4250,2801,1449,0.340941176
MG,JOÃO MONLEVADE,2022,60707,47995,12712,0.209399246
MG,JOÃO PINHEIRO,2022,38239,28273,9966,0.26062397
MG,JUATUBA,2022,22894,18280,4614,0.201537521
MG,JUIZ DE FORA,2022,418213,332257,85956,0.205531631
MG,JURAMENTO,2022,4478,3627,851,0.190040197
MG,JURUAIA,2022,9038,7376,1662,0.183890241
MG,JUVENÍLIA,2022,5667,3869,1798,0.317275454
MG,LADAINHA,2022,12331,7923,4408,0.357473035
MG,LAGAMAR,2022,6509,4978,1531,0.235212782
MG,LAGOA DA PRATA,2022,36446,28515,7931,0.217609614
MG,LAGOA DOS PATOS,2022,3767,2645,1122,0.297849748
MG,LAGOA DOURADA,2022,10074,8644,1430,0.141949573
MG,LAGOA FORMOSA,2022,14687,12111,2576,0.175393205
MG,LAGOA GRANDE,2022,7471,5770,1701,0.227680364
MG,LAGOA SANTA,2022,49709,40192,9517,0.191454264
MG,LAJINHA,2022,14921,12248,2673,0.179143489
MG,LAMBARI,2022,16983,13311,3672,0.216216216
MG,LAMIM,2022,3526,2817,709,0.201077708
MG,LARANJAL,2022,5596,4539,1057,0.188884918
MG,LASSANCE,2022,5827,4215,1612,0.276643213
MG,LAVRAS,2022,74825,59440,15385,0.205613097
MG,LEANDRO FERREIRA,2022,3321,2635,686,0.206564288
MG,LEME DO PRADO,2022,4280,2958,1322,0.308878505
MG,LEOPOLDINA,2022,41122,31876,9246,0.22484315
MG,LIBERDADE,2022,4441,3484,957,0.215492006
MG,LIMA DUARTE,2022,14603,11268,3335,0.228377731
MG,LIMEIRA DO OESTE,2022,6095,4981,1114,0.182772765
MG,LONTRA,2022,8289,5933,2356,0.284232115
MG,LUISBURGO,2022,5584,4415,1169,0.209348138
MG,LUISLÂNDIA,2022,6503,4596,1907,0.29324927
MG,LUMINÁRIAS,2022,4456,3645,811,0.182001795
MG,LUZ,2022,14861,10799,4062,0.273332885
MG,MACHACALIS,2022,6038,4468,1570,0.260019874
MG,MACHADO,2022,30277,23718,6559,0.216633088
MG,MADRE DE DEUS DE MINAS,2022,4343,3624,719,0.165553765
MG,MALACACHETA,2022,15617,10353,5264,0.337068579
MG,MAMONAS,2022,5658,4693,965,0.170554966
MG,MANGA,2022,16200,11398,4802,0.296419753
MG,MANHUAÇU,2022,60406,46994,13412,0.222030924
MG,MANHUMIRIM,2022,17140,12941,4199,0.244982497
MG,MANTENA,2022,20765,14849,5916,0.28490248
MG,MAR DE ESPANHA,2022,10044,8310,1734,0.172640382
MG,MARAVILHAS,2022,6281,5222,1059,0.168603726
MG,MARIA DA FÉ,2022,12127,9967,2160,0.17811495
MG,MARIANA,2022,50823,40953,9870,0.194203412
MG,MARILAC,2022,4467,3123,1344,0.300873069
MG,MARIPÁ DE MINAS,2022,3007,2418,589,0.195876289
MG,MARLIÉRIA,2022,4311,3402,909,0.21085595
MG,MARMELÓPOLIS,2022,2919,2368,551,0.188763275
MG,MARTINHO CAMPOS,2022,11510,8640,2870,0.249348393
MG,MARTINS SOARES,2022,7781,6086,1695,0.217838324
MG,MATA VERDE,2022,6796,5173,1623,0.238816951
MG,MATERLÂNDIA,2022,4454,2804,1650,0.370453525
MG,MATEUS LEME,2022,27541,21229,6312,0.229185578
MG,MATHIAS LOBATO,2022,3296,2376,920,0.279126214
MG,MATIAS BARBOSA,2022,11989,9611,2378,0.198348486
MG,MATIAS CARDOSO,2022,6984,5127,1857,0.265893471
MG,MATIPÓ,2022,14084,11405,2679,0.190215848
MG,MATO VERDE,2022,10642,8632,2010,0.188874272
MG,MATOZINHOS,2022,30089,24128,5961,0.198112267
MG,MATUTINA,2022,3486,2529,957,0.274526678
MG,MEDEIROS,2022,3114,2411,703,0.225754656
MG,MEDINA,2022,16217,11584,4633,0.285687858
MG,MENDES PIMENTEL,2022,5244,3724,1520,0.289855072
MG,MERCÊS,2022,8808,6814,1994,0.226385104
MG,MESQUITA,2022,5568,3835,1733,0.311242816
MG,MINAS NOVAS,2022,22449,13993,8456,0.376676021
MG,MINDURI,2022,3302,2585,717,0.217141127
MG,MIRABELA,2022,11517,8526,2991,0.259703048
MG,MIRADOURO,2022,8101,6588,1513,0.186767066
MG,MIRAVÂNIA,2022,4057,2627,1430,0.3524772
MG,MIRAÍ,2022,10583,8116,2467,0.233109704
MG,MOEDA,2022,4982,4233,749,0.150341228
MG,MOEMA,2022,6692,5180,1512,0.225941423
MG,MONJOLOS,2022,2308,1620,688,0.298093588
MG,MONSENHOR PAULO,2022,6963,5461,1502,0.215711619
MG,MONTALVÂNIA,2022,13113,9000,4113,0.313658202
MG,MONTE ALEGRE DE MINAS,2022,15479,11212,4267,0.275663803
MG,MONTE AZUL,2022,17617,13888,3729,0.211670545
MG,MONTE BELO,2022,10983,8522,2461,0.224073568
MG,MONTE CARMELO,2022,36494,28171,8323,0.228064887
MG,MONTE FORMOSO,2022,4534,2851,1683,0.371195412
MG,MONTE SANTO DE MINAS,2022,17308,12757,4551,0.262941992
MG,MONTE SIÃO,2022,18600,14572,4028,0.21655914
MG,MONTES CLAROS,2022,287668,232938,54730,0.190254043
MG,MONTEZUMA,2022,5969,4273,1696,0.284134696
MG,MORADA NOVA DE MINAS,2022,7318,5481,1837,0.25102487
MG,MORRO DA GARÇA,2022,2856,2135,721,0.25245098
MG,MORRO DO PILAR,2022,3689,2757,932,0.252642993
MG,MUNHOZ,2022,5939,4730,1209,0.203569625
MG,MURIAÉ,2022,78413,63030,15383,0.196179205
MG,MUTUM,2022,21432,16528,4904,0.228816723
MG,MUZAMBINHO,2022,18085,13995,4090,0.226154271
MG,MÁRIO CAMPOS,2022,12404,9987,2417,0.194856498
MG,NACIP RAYDAN,2022,2933,1825,1108,0.377770201
MG,NANUQUE,2022,29810,20643,9167,0.307514257
MG,NAQUE,2022,5448,4059,1389,0.254955947
MG,NATALÂNDIA,2022,3091,2398,693,0.224199288
MG,NATÉRCIA,2022,4111,3242,869,0.211384091
MG,NAZARENO,2022,6548,5299,1249,0.190745266
MG,NEPOMUCENO,2022,20966,15978,4988,0.237908996
MG,NINHEIRA,2022,8356,5624,2732,0.326950694
MG,NOVA BELÉM,2022,3634,2593,1041,0.2864612
MG,NOVA ERA,2022,15084,11528,3556,0.235746486
MG,NOVA LIMA,2022,76500,61832,14668,0.191738562
MG,NOVA MÓDICA,2022,3681,2619,1062,0.288508557
MG,NOVA PONTE,2022,12665,9569,3096,0.244453218
MG,NOVA PORTEIRINHA,2022,5709,4721,988,0.173060081
MG,NOVA RESENDE,2022,12899,10451,2448,0.189782154
MG,NOVA SERRANA,2022,59528,48511,11017,0.185072571
MG,NOVA UNIÃO,2022,5567,4273,1294,0.232441171
MG,NOVO CRUZEIRO,2022,24898,15213,9685,0.388987067
MG,NOVO ORIENTE DE MINAS,2022,9017,5887,3130,0.347122103
MG,NOVORIZONTE,2022,4776,3485,1291,0.270309883
MG,OLARIA,2022,2276,1796,480,0.210896309
MG,OLHOS D'ÁGUA,2022,5316,3930,1386,0.260722348
MG,OLIVEIRA,2022,33473,26845,6628,0.198010337
MG,OLIVEIRA FORTES,2022,2427,2016,411,0.16934487
MG,OLÍMPIO NORONHA,2022,2660,2071,589,0.221428571
MG,ONÇA DE PITANGUI,2022,3310,2648,662,0.2
MG,ORATÓRIOS,2022,4447,3486,961,0.216100742
MG,ORIZÂNIA,2022,6446,4991,1455,0.225721378
MG,OURO BRANCO,2022,31533,25658,5875,0.186312752
MG,OURO FINO,2022,25272,19369,5903,0.233578664
MG,OURO PRETO,2022,63712,51924,11788,0.18502009
MG,OURO VERDE DE MINAS,2022,7063,5058,2005,0.283873708
MG,PADRE CARVALHO,2022,4987,3191,1796,0.360136355
MG,PADRE PARAÍSO,2022,14183,9357,4826,0.340266516
MG,PAI PEDRO,2022,5348,3951,1397,0.261219147
MG,PAINEIRAS,2022,4220,3255,965,0.228672986
MG,PAINS,2022,6826,5471,1355,0.198505713
MG,PAIVA,2022,1760,1403,357,0.202840909
MG,PALMA,2022,5374,4182,1192,0.221808709
MG,PALMÓPOLIS,2022,6175,4124,2051,0.332145749
MG,PAPAGAIOS,2022,11470,9623,1847,0.161028771
MG,PARACATU,2022,66737,51200,15537,0.232809386
MG,PARAGUAÇU,2022,16931,13185,3746,0.22125096
MG,PARAISÓPOLIS,2022,16466,12884,3582,0.217539172
MG,PARAOPEBA,2022,20130,16363,3767,0.187133631
MG,PARÁ DE MINAS,2022,66067,52829,13238,0.200372349
MG,PASSA QUATRO,2022,13372,10659,2713,0.202886629
MG,PASSA TEMPO,2022,7647,5858,1789,0.233947953
MG,PASSA VINTE,2022,2230,1912,318,0.142600897
MG,PASSABÉM,2022,1817,1430,387,0.212988442
MG,PASSOS,2022,80821,62330,18491,0.228789547
MG,PATIS,2022,5269,3837,1432,0.271778326
MG,PATOS DE MINAS,2022,114130,87985,26145,0.229080873
MG,PATROCÍNIO,2022,67804,53028,14776,0.217922246
MG,PATROCÍNIO DO MURIAÉ,2022,5181,4140,1041,0.200926462
MG,PAULA CÂNDIDO,2022,7763,6080,1683,0.21679763
MG,PAULISTAS,2022,4313,3003,1310,0.303732901
MG,PAVÃO,2022,6245,4514,1731,0.277181745
MG,PEDRA AZUL,2022,18640,12369,6271,0.336427039
MG,PEDRA BONITA,2022,5762,4808,954,0.165567511
MG,PEDRA DO ANTA,2022,3268,2767,501,0.153304774
MG,PEDRA DO INDAIÁ,2022,3621,2935,686,0.189450428
MG,PEDRA DOURADA,2022,2740,2264,476,0.173722628
MG,PEDRALVA,2022,9497,7414,2083,0.219332421
MG,PEDRAS DE MARIA DA CRUZ,2022,7913,5412,2501,0.316062176
MG,PEDRINÓPOLIS,2022,3146,2521,625,0.198664971
MG,PEDRO LEOPOLDO,2022,48453,39575,8878,0.183229109
MG,PEDRO TEIXEIRA,2022,2323,1993,330,0.142057684
MG,PEQUERI,2022,3216,2548,668,0.207711443
MG,PEQUI,2022,3666,3001,665,0.181396618
MG,PERDIGÃO,2022,8062,6570,1492,0.185065741
MG,PERDIZES,2022,13571,10072,3499,0.257829195
MG,PERDÕES,2022,17270,13691,3579,0.207237985
MG,PERIQUITO,2022,6553,4614,1939,0.29589501
MG,PESCADOR,2022,3588,2391,1197,0.33361204
MG,PEÇANHA,2022,13549,9041,4508,0.332718282
MG,PIAU,2022,3043,2528,515,0.169240881
MG,PIEDADE DE CARATINGA,2022,7992,5874,2118,0.265015015
MG,PIEDADE DE PONTE NOVA,2022,3839,2956,883,0.230007815
MG,PIEDADE DO RIO GRANDE,2022,4101,3105,996,0.242867593
MG,PIEDADE DOS GERAIS,2022,5041,3821,1220,0.242015473
MG,PIMENTA,2022,6980,5580,1400,0.200573066
MG,PINGO D'ÁGUA,2022,4142,3188,954,0.230323515
MG,PINTÓPOLIS,2022,6517,4271,2246,0.344637103
MG,PIRACEMA,2022,5585,4888,697,0.124798568
MG,PIRAJUBA,2022,4379,3383,996,0.227449189
MG,PIRANGA,2022,13898,9792,4106,0.295438193
MG,PIRANGUINHO,2022,7156,5775,1381,0.192984908
MG,PIRANGUÇU,2022,4648,3699,949,0.204173838
MG,PIRAPETINGA,2022,9844,8002,1842,0.187119057
MG,PIRAPORA,2022,41505,31237,10268,0.24739188
MG,PIRAÚBA,2022,9648,7641,2007,0.208022388
MG,PITANGUI,2022,21212,17430,3782,0.178295305
MG,PIUMHI,2022,25729,19561,6168,0.239729488
MG,PLANURA,2022,8315,6176,2139,0.257245941
MG,POCRANE,2022,7457,5617,1840,0.246748022
MG,POMPÉU,2022,24246,18528,5718,0.235832715
MG,PONTE NOVA,2022,44823,36119,8704,0.194186021
MG,PONTO CHIQUE,2022,3868,2642,1226,0.316959669
MG,PONTO DOS VOLANTES,2022,9461,6455,3006,0.317725399
MG,PORTEIRINHA,2022,31393,23983,7410,0.236039882
MG,PORTO FIRME,2022,9139,7062,2077,0.227267754
MG,POTÉ,2022,12547,8499,4048,0.322626923
MG,POUSO ALEGRE,2022,108407,86815,21592,0.19917533
MG,POUSO ALTO,2022,5528,4508,1020,0.184515195
MG,POÇO FUNDO,2022,13020,10434,2586,0.198617512
MG,POÇOS DE CALDAS,2022,121976,91617,30359,0.248893225
MG,PRADOS,2022,7334,6195,1139,0.155304063
MG,PRATA,2022,22232,16206,6026,0.271050738
MG,PRATINHA,2022,2990,2350,640,0.214046823
MG,PRATÁPOLIS,2022,7485,5799,1686,0.225250501
MG,PRESIDENTE BERNARDES,2022,5682,4218,1464,0.257655755
MG,PRESIDENTE JUSCELINO,2022,4109,2699,1410,0.343149185
MG,PRESIDENTE KUBITSCHEK,2022,2923,2296,627,0.214505645
MG,PRESIDENTE OLEGÁRIO,2022,16456,12011,4445,0.270114244
MG,PRUDENTE DE MORAIS,2022,8139,6911,1228,0.150878486
MG,QUARTEL GERAL,2022,3299,2737,562,0.170354653
MG,QUELUZITO,2022,2528,2107,421,0.16653481
MG,RAPOSOS,2022,13332,11233,2099,0.157440744
MG,RAUL SOARES,2022,18151,13837,4314,0.237672855
MG,RECREIO,2022,7937,6134,1803,0.227163916
MG,REDUTO,2022,5862,4499,1363,0.2325145
MG,RESENDE COSTA,2022,9415,7774,1641,0.174296336
MG,RESPLENDOR,2022,13103,9097,4006,0.305731512
MG,RESSAQUINHA,2022,4248,3622,626,0.147363465
MG,RIACHINHO,2022,5669,4211,1458,0.257188217
MG,RIACHO DOS MACHADOS,2022,7841,5684,2157,0.275092463
MG,RIBEIRÃO DAS NEVES,2022,223935,175884,48051,0.214575658
MG,RIBEIRÃO VERMELHO,2022,3309,2742,567,0.171350861
MG,RIO ACIMA,2022,8564,7081,1483,0.173166745
MG,RIO CASCA,2022,11132,8025,3107,0.279105282
MG,RIO DO PRADO,2022,4269,3028,1241,0.290700398
MG,RIO DOCE,2022,2479,2035,444,0.179104478
MG,RIO ESPERA,2022,5602,4251,1351,0.24116387
MG,RIO MANSO,2022,4725,3821,904,0.191322751
MG,RIO NOVO,2022,7298,5716,1582,0.216771718
MG,RIO PARANAÍBA,2022,11093,8105,2988,0.269359055
MG,RIO PARDO DE MINAS,2022,21564,15772,5792,0.268595808
MG,RIO PIRACICABA,2022,12389,9566,2823,0.227863427
MG,RIO POMBA,2022,14264,11330,2934,0.205692653
MG,RIO PRETO,2022,5311,4173,1138,0.214272265
MG,RIO VERMELHO,2022,10856,6460,4396,0.404937362
MG,RITÁPOLIS,2022,4690,3753,937,0.19978678
MG,ROCHEDO DE MINAS,2022,2443,1955,488,0.1997544
MG,RODEIRO,2022,6676,5405,1271,0.190383463
MG,ROMARIA,2022,3179,2611,568,0.178672539
MG,ROSÁRIO DA LIMEIRA,2022,5072,4116,956,0.188485804
MG,RUBELITA,2022,7466,4849,2617,0.350522368
MG,RUBIM,2022,6898,4935,1963,0.284575239
MG,SABARÁ,2022,97926,78033,19893,0.20314319
MG,SABINÓPOLIS,2022,12708,8353,4355,0.342697513
MG,SACRAMENTO,2022,20064,15447,4617,0.230113636
MG,SALINAS,2022,32562,24140,8422,0.258645046
MG,SALTO DA DIVISA,2022,4963,3594,1369,0.275841225
MG,SANTA BÁRBARA,2022,23849,19255,4594,0.192628622
MG,SANTA BÁRBARA DO LESTE,2022,7306,5681,1625,0.222419929
MG,SANTA BÁRBARA DO MONTE VERDE,2022,3292,2621,671,0.203827461
MG,SANTA BÁRBARA DO TUGÚRIO,2022,4443,3534,909,0.204591492
MG,SANTA CRUZ DE MINAS,2022,6533,5321,1212,0.185519669
MG,SANTA CRUZ DE SALINAS,2022,4347,2999,1348,0.310098919
MG,SANTA CRUZ DO ESCALVADO,2022,4865,3844,1021,0.209866393
MG,SANTA EFIGÊNIA DE MINAS,2022,4179,2644,1535,0.367312754
MG,SANTA FÉ DE MINAS,2022,3581,2474,1107,0.309131528
MG,SANTA HELENA DE MINAS,2022,5462,3878,1584,0.290003662
MG,SANTA JULIANA,2022,10519,8467,2052,0.195075578
MG,SANTA LUZIA,2022,168807,136936,31871,0.188801412
MG,SANTA MARGARIDA,2022,12835,10387,2448,0.190728477
MG,SANTA MARIA DE ITABIRA,2022,8735,6862,1873,0.214424728
MG,SANTA MARIA DO SALTO,2022,4439,3059,1380,0.310880829
MG,SANTA MARIA DO SUAÇUÍ,2022,12438,7953,4485,0.360588519
MG,SANTA RITA DE CALDAS,2022,7057,5644,1413,0.200226725
MG,SANTA RITA DE IBITIPOCA,2022,3332,2610,722,0.216686675
MG,SANTA RITA DE JACUTINGA,2022,4195,3449,746,0.177830751
MG,SANTA RITA DE MINAS,2022,5980,4606,1374,0.229765886
MG,SANTA RITA DO ITUETO,2022,5049,3713,1336,0.264606853
MG,SANTA RITA DO SAPUCAÍ,2022,30996,25002,5994,0.193379791
MG,SANTA ROSA DA SERRA,2022,3295,2435,860,0.261001517
MG,SANTA VITÓRIA,2022,17328,13238,4090,0.236034164
MG,SANTANA DA VARGEM,2022,5957,5027,930,0.156118852
MG,SANTANA DE CATAGUASES,2022,3215,2693,522,0.162363919
MG,SANTANA DE PIRAPAMA,2022,7402,5712,1690,0.228316671
MG,SANTANA DO DESERTO,2022,3370,2749,621,0.184272997
MG,SANTANA DO GARAMBÉU,2022,2279,1861,418,0.183413778
MG,SANTANA DO JACARÉ,2022,3997,3142,855,0.213910433
MG,SANTANA DO MANHUAÇU,2022,7713,5802,1911,0.247763516
MG,SANTANA DO PARAÍSO,2022,23806,18029,5777,0.242669915
MG,SANTANA DO RIACHO,2022,5673,4336,1337,0.235677772
MG,SANTANA DOS MONTES,2022,3760,3082,678,0.180319149
MG,SANTO ANTÔNIO DO AMPARO,2022,14059,11131,2928,0.208265168
MG,SANTO ANTÔNIO DO AVENTUREIRO,2022,3590,2899,691,0.192479109
MG,SANTO ANTÔNIO DO GRAMA,2022,3965,3076,889,0.224211854
MG,SANTO ANTÔNIO DO ITAMBÉ,2022,3929,2344,1585,0.403410537
MG,SANTO ANTÔNIO DO JACINTO,2022,9339,6419,2920,0.312667309
MG,SANTO ANTÔNIO DO MONTE,2022,20369,16158,4211,0.206735726
MG,SANTO ANTÔNIO DO RETIRO,2022,6284,4550,1734,0.275938892
MG,SANTO ANTÔNIO DO RIO ABAIXO,2022,2138,1536,602,0.281571562
MG,SANTO HIPÓLITO,2022,3048,2134,914,0.299868766
MG,SANTOS DUMONT,2022,38509,30150,8359,0.21706614
MG,SAPUCAÍ-MIRIM,2022,5551,4323,1228,0.221221402
MG,SARDOÁ,2022,5020,3311,1709,0.340438247
MG,SARZEDO,2022,25015,20531,4484,0.179252449
MG,SEM PEIXE,2022,3584,2678,906,0.252790179
MG,SENADOR AMARAL,2022,5432,4373,1059,0.194955817
MG,SENADOR CORTES,2022,2438,1987,451,0.184987695
MG,SENADOR FIRMINO,2022,6842,5298,1544,0.22566501
MG,SENADOR JOSÉ BENTO,2022,2232,1772,460,0.20609319
MG,SENADOR MODESTINO GONÇALVES,2022,4594,3045,1549,0.337178929
MG,SENHORA DE OLIVEIRA,2022,5573,4337,1236,0.221783599
MG,SENHORA DO PORTO,2022,3269,2288,981,0.300091771
MG,SENHORA DOS REMÉDIOS,2022,8240,6762,1478,0.179368932
MG,SERICITA,2022,6612,5299,1313,0.198578342
MG,SERITINGA,2022,1892,1495,397,0.209830867
MG,SERRA AZUL DE MINAS,2022,3691,2339,1352,0.366296397
MG,SERRA DA SAUDADE,2022,1107,925,182,0.164408311
MG,SERRA DO SALITRE,2022,9297,7011,2286,0.24588577
MG,SERRA DOS AIMORÉS,2022,5705,4137,1568,0.274846626
MG,SERRANIA,2022,6553,4914,1639,0.250114451
MG,SERRANOS,2022,2091,1672,419,0.200382592
MG,SERRANÓPOLIS DE MINAS,2022,3967,3042,925,0.233173683
MG,SERRO,2022,17304,11687,5617,0.324607027
MG,SETE LAGOAS,2022,172585,140084,32501,0.188318799
MG,SETUBINHA,2022,9009,5801,3208,0.356088356
MG,SILVEIRÂNIA,2022,2542,2241,301,0.1184107
MG,SILVIANÓPOLIS,2022,4878,3821,1057,0.216687167
MG,SIMONÉSIA,2022,15717,12129,3588,0.228287841
MG,SIMÃO PEREIRA,2022,2996,2499,497,0.16588785
MG,SOBRÁLIA,2022,4475,3175,1300,0.290502793
MG,SOLEDADE DE MINAS,2022,5058,4023,1035,0.204626335
MG,SÃO BENTO ABADE,2022,4166,3266,900,0.216034566
MG,SÃO BRÁS DO SUAÇUÍ,2022,3591,2838,753,0.209690894
MG,SÃO DOMINGOS DAS DORES,2022,5391,4177,1214,0.225190132
MG,SÃO DOMINGOS DO PRATA,2022,14248,11067,3181,0.223259405
MG,SÃO FRANCISCO,2022,41458,28517,12941,0.312147233
MG,SÃO FRANCISCO DE PAULA,2022,5954,4810,1144,0.192139738
MG,SÃO FRANCISCO DE SALES,2022,4623,3653,970,0.209820463
MG,SÃO FRANCISCO DO GLÓRIA,2022,4000,3396,604,0.151
MG,SÃO FÉLIX DE MINAS,2022,3206,2453,753,0.234872115
MG,SÃO GERALDO,2022,7096,5710,1386,0.195321308
MG,SÃO GERALDO DA PIEDADE,2022,3955,2498,1457,0.368394437
MG,SÃO GERALDO DO BAIXIO,2022,3179,2286,893,0.280905945
MG,SÃO GONÇALO DO ABAETÉ,2022,5255,4036,1219,0.231969553
MG,SÃO GONÇALO DO PARÁ,2022,8731,7008,1723,0.197342802
MG,SÃO GONÇALO DO RIO ABAIXO,2022,10465,9107,1358,0.129765886
MG,SÃO GONÇALO DO RIO PRETO,2022,3025,2123,902,0.298181818
MG,SÃO GONÇALO DO SAPUCAÍ,2022,19264,14519,4745,0.246314369
MG,SÃO GOTARDO,2022,29169,21257,7912,0.271246872
MG,SÃO JOAQUIM DE BICAS,2022,21374,16797,4577,0.214138673
MG,SÃO JOSÉ DA BARRA,2022,6563,5124,1439,0.219259485
MG,SÃO JOSÉ DA LAPA,2022,19696,16220,3476,0.176482535
MG,SÃO JOSÉ DA SAFIRA,2022,3969,2765,1204,0.30335097
MG,SÃO JOSÉ DA VARGINHA,2022,3848,2958,890,0.231288981
MG,SÃO JOSÉ DO ALEGRE,2022,3673,2969,704,0.191668935
MG,SÃO JOSÉ DO DIVINO,2022,3347,2410,937,0.279952196
MG,SÃO JOSÉ DO GOIABAL,2022,4749,3472,1277,0.268898716
MG,SÃO JOSÉ DO JACURI,2022,5338,3895,1443,0.270325965
MG,SÃO JOSÉ DO MANTIMENTO,2022,2777,2266,511,0.184011523
MG,SÃO JOÃO BATISTA DO GLÓRIA,2022,6252,4967,1285,0.205534229
MG,SÃO JOÃO DA LAGOA,2022,4891,3741,1150,0.235125741
MG,SÃO JOÃO DA MATA,2022,3003,2386,617,0.205461205
MG,SÃO JOÃO DA PONTE,2022,22632,15171,7461,0.32966596
MG,SÃO JOÃO DAS MISSÕES,2022,9481,7106,2375,0.250501002
MG,SÃO JOÃO DEL REI,2022,70311,56882,13429,0.190994297
MG,SÃO JOÃO DO MANHUAÇU,2022,9134,7297,1837,0.201116707
MG,SÃO JOÃO DO MANTENINHA,2022,5187,3777,1410,0.27183343
MG,SÃO JOÃO DO ORIENTE,2022,7261,5332,1929,0.265665886
MG,SÃO JOÃO DO PACUÍ,2022,3927,2917,1010,0.257193787
MG,SÃO JOÃO DO PARAÍSO,2022,17294,12540,4754,0.274893026
MG,SÃO JOÃO EVANGELISTA,2022,12799,9029,3770,0.294554262
MG,SÃO JOÃO NEPOMUCENO,2022,20589,16098,4491,0.218126184
MG,SÃO LOURENÇO,2022,34752,26964,7788,0.22410221
MG,SÃO MIGUEL DO ANTA,2022,6064,5129,935,0.154188654
MG,SÃO PEDRO DA UNIÃO,2022,4257,3332,925,0.217289171
MG,SÃO PEDRO DO SUAÇUÍ,2022,4765,3509,1256,0.263588667
MG,SÃO PEDRO DOS FERROS,2022,6490,4663,1827,0.281510015
MG,SÃO ROMÃO,2022,7177,4635,2542,0.354186986
MG,SÃO ROQUE DE MINAS,2022,5636,4303,1333,0.236515259
MG,SÃO SEBASTIÃO DA BELA VISTA,2022,5708,4519,1189,0.208304135
MG,SÃO SEBASTIÃO DA VARGEM ALEGRE,2022,2756,2342,414,0.150217707
MG,SÃO SEBASTIÃO DO ANTA,2022,5567,3849,1718,0.308604275
MG,SÃO SEBASTIÃO DO MARANHÃO,2022,8928,5605,3323,0.372199821
MG,SÃO SEBASTIÃO DO OESTE,2022,6162,5170,992,0.160986693
MG,SÃO SEBASTIÃO DO PARAÍSO,2022,51088,38204,12884,0.252192296
MG,SÃO SEBASTIÃO DO RIO PRETO,2022,1875,1356,519,0.2768
MG,SÃO SEBASTIÃO DO RIO VERDE,2022,2075,1744,331,0.159518072
MG,SÃO THOMÉ DAS LETRAS,2022,4883,3994,889,0.182060209
MG,SÃO TIAGO,2022,9100,7440,1660,0.182417582
MG,SÃO TOMÁS DE AQUINO,2022,5907,4469,1438,0.243439986
MG,SÃO VICENTE DE MINAS,2022,5726,4465,1261,0.220223542
MG,TABULEIRO,2022,4231,3220,1011,0.238950603
MG,TAIOBEIRAS,2022,26411,19920,6491,0.245768808
MG,TAPARUBA,2022,3657,2823,834,0.228055783
MG,TAPIRA,2022,4578,3646,932,0.20358235
MG,TAPIRAÍ,2022,1862,1508,354,0.190118153
MG,TAQUARAÇU DE MINAS,2022,4760,3699,1061,0.22289916
MG,TARUMIRIM,2022,10760,7532,3228,0.3
MG,TEIXEIRAS,2022,10567,8376,2191,0.207343617
MG,TEÓFILO OTONI,2022,106388,77228,29160,0.274091063
MG,TIMÓTEO,2022,59866,47348,12518,0.209100324
MG,TIRADENTES,2022,6956,5712,1244,0.178838413
MG,TIROS,2022,6246,4392,1854,0.296829971
MG,TOCANTINS,2022,13436,10797,2639,0.196412623
MG,TOCOS DO MOJI,2022,3970,3339,631,0.158942065
MG,TOLEDO,2022,6382,4962,1420,0.222500783
MG,TOMBOS,2022,7195,5551,1644,0.228492008
MG,TRÊS CORAÇÕES,2022,57163,44615,12548,0.219512622
MG,TRÊS MARIAS,2022,24311,18239,6072,0.249763482
MG,TRÊS PONTAS,2022,45185,36287,8898,0.196923758
MG,TUMIRITINGA,2022,5488,3864,1624,0.295918367
MG,TUPACIGUARA,2022,20238,15500,4738,0.234114043
MG,TURMALINA,2022,15850,12256,3594,0.226750789
MG,TURVOLÂNDIA,2022,4587,3611,976,0.212775234
MG,UBAPORANGA,2022,10475,7943,2532,0.241718377
MG,UBAÍ,2022,9458,6786,2672,0.282512159
MG,UBERABA,2022,233247,185838,47409,0.203256634
MG,UBERLÂNDIA,2022,514413,415567,98846,0.192152998
MG,UBÁ,2022,71921,57399,14522,0.201915991
MG,UMBURATIBA,2022,2656,1853,803,0.302334337
MG,UNAÍ,2022,63219,48090,15129,0.239310967
MG,UNIÃO DE MINAS,2022,2989,2454,535,0.178989629
MG,URUANA DE MINAS,2022,3480,2557,923,0.265229885
MG,URUCUIA,2022,7717,5413,2304,0.298561617
MG,URUCÂNIA,2022,8618,6749,1869,0.216871664
MG,VARGEM ALEGRE,2022,6102,4332,1770,0.29006883
MG,VARGEM BONITA,2022,2597,1950,647,0.249133616
MG,VARGEM GRANDE DO RIO PARDO,2022,4206,3155,1051,0.249881122
MG,VARGINHA,2022,102682,82851,19831,0.193130247
MG,VARJÃO DE MINAS,2022,6559,5092,1467,0.223662144
MG,VARZELÂNDIA,2022,16214,11038,5176,0.319230295
MG,VAZANTE,2022,16668,12608,4060,0.243580514
MG,VERDELÂNDIA,2022,6924,4880,2044,0.295205084
MG,VEREDINHA,2022,5092,3765,1327,0.26060487
MG,VERMELHO NOVO,2022,4779,3800,979,0.204854572
MG,VERÍSSIMO,2022,3038,2248,790,0.2600395
MG,VESPASIANO,2022,89390,71280,18110,0.202595369
MG,VIEIRAS,2022,3679,3145,534,0.145148138
MG,VIRGEM DA LAPA,2022,10277,6910,3367,0.327624793
MG,VIRGINÓPOLIS,2022,8940,6057,2883,0.322483221
MG,VIRGOLÂNDIA,2022,4601,3193,1408,0.30602043
MG,VIRGÍNIA,2022,7282,5857,1425,0.195687998
MG,VISCONDE DO RIO BRANCO,2022,30399,24382,6017,0.197934143
MG,VIÇOSA,2022,60660,48536,12124,0.199868117
MG,VOLTA GRANDE,2022,4350,3107,1243,0.285747126
MG,VÁRZEA DA PALMA,2022,27079,19789,7290,0.269212305
MG,WENCESLAU BRAZ,2022,2470,2100,370,0.149797571
MG,ÁGUA BOA,2022,11888,7785,4103,0.345137954
MG,ÁGUA COMPRIDA,2022,2386,1822,564,0.236378877
MG,ÁGUAS FORMOSAS,2022,15964,11203,4761,0.298233525
MG,ÁGUAS VERMELHAS,2022,10338,6961,3377,0.326658928
MS,ALCINÓPOLIS,2022,3610,2701,909,0.251800554
MS,AMAMBAI,2022,26348,20048,6300,0.239107333
MS,ANASTÁCIO,2022,18204,13571,4633,0.254504505
MS,ANAURILÂNDIA,2022,6229,4704,1525,0.244822604
MS,ANGÉLICA,2022,8666,6479,2187,0.252365567
MS,ANTÔNIO JOÃO,2022,7604,5908,1696,0.223040505
MS,APARECIDA DO TABOADO,2022,19301,13842,5459,0.282835086
MS,AQUIDAUANA,2022,35880,26511,9369,0.261120401
MS,ARAL MOREIRA,2022,7495,6143,1352,0.180386925
MS,BANDEIRANTES,2022,6166,4811,1355,0.219753487
MS,BATAGUASSU,2022,19335,14122,5213,0.269614688
MS,BATAYPORÃ,2022,8175,6242,1933,0.236452599
MS,BELA VISTA,2022,16295,11981,4314,0.264743786
MS,BODOQUENA,2022,6660,5134,1526,0.229129129
MS,BONITO,2022,17682,13657,4025,0.227632621
MS,BRASILÂNDIA,2022,9469,6454,3015,0.318407435
MS,CAARAPÓ,2022,20849,16381,4468,0.214302844
MS,CAMAPUÃ,2022,11108,8599,2509,0.225873245
MS,CAMPO GRANDE,2022,639873,527474,112399,0.175658295
MS,CARACOL,2022,4553,3524,1029,0.226004832
MS,CASSILÂNDIA,2022,16093,11399,4694,0.291679612
MS,CHAPADÃO DO SUL,2022,21128,15623,5505,0.260554714
MS,CORGUINHO,2022,4037,3061,976,0.241763686
MS,CORONEL SAPUCAIA,2022,11694,9200,2494,0.213271763
MS,CORUMBÁ,2022,70963,52903,18060,0.254498823
MS,COSTA RICA,2022,22565,16129,6436,0.285220474
MS,COXIM,2022,26196,19246,6950,0.265307681
MS,DEODÁPOLIS,2022,10411,8123,2288,0.219767554
MS,DOIS IRMÃOS DO BURITI,2022,8221,6352,1869,0.227344605
MS,DOURADINA,2022,4701,4081,620,0.131886833
MS,DOURADOS,2022,169042,133855,35187,0.20815537
MS,ELDORADO,2022,8942,6465,2477,0.277007381
MS,FIGUEIRÃO,2022,2466,1954,512,0.207623682
MS,FÁTIMA DO SUL,2022,16563,13101,3462,0.209020105
MS,GLÓRIA DE DOURADOS,2022,7727,6103,1624,0.210172124
MS,GUIA LOPES DA LAGUNA,2022,7743,5751,1992,0.257264626
MS,IGUATEMI,2022,10633,7832,2801,0.263425186
MS,INOCÊNCIA,2022,6524,4623,1901,0.291385653
MS,ITAPORÃ,2022,13983,11315,2668,0.190803118
MS,ITAQUIRAÍ,2022,14287,10281,4006,0.280394764
MS,IVINHEMA,2022,20510,15931,4579,0.223256948
MS,JAPORÃ,2022,5886,4567,1319,0.224091064
MS,JARAGUARI,2022,5237,4089,1148,0.219209471
MS,JARDIM,2022,18374,13386,4988,0.271470556
MS,JATEÍ,2022,4151,3380,771,0.185738376
MS,JUTI,2022,5516,4174,1342,0.243292241
MS,LADÁRIO,2022,14088,10430,3658,0.259653606
MS,LAGUNA CARAPÃ,2022,5259,4391,868,0.16505039
MS,MARACAJU,2022,28259,22287,5972,0.211330903
MS,MIRANDA,2022,19453,14681,4772,0.245309207
MS,MUNDO NOVO,2022,14245,10773,3472,0.243734644
MS,NAVIRAÍ,2022,36937,27964,8973,0.242927146
MS,NIOAQUE,2022,10677,8101,2576,0.241266273
MS,NOVA ALVORADA DO SUL,2022,15633,11124,4509,0.288428325
MS,NOVA ANDRADINA,2022,34908,26062,8846,0.253408961
MS,NOVO HORIZONTE DO SUL,2022,3865,3002,863,0.223285899
MS,PARANAÍBA,2022,31288,23583,7705,0.246260547
MS,PARANHOS,2022,8598,6328,2270,0.264014887
MS,PARAÍSO DAS ÁGUAS,2022,4226,3065,1161,0.274727875
MS,PEDRO GOMES,2022,5828,4389,1439,0.246911462
MS,PONTA PORÃ,2022,70278,53150,17128,0.243717806
MS,PORTO MURTINHO,2022,8386,5663,2723,0.324707846
MS,RIBAS DO RIO PARDO,2022,14569,10301,4268,0.292950786
MS,RIO BRILHANTE,2022,25161,19545,5616,0.223202575
MS,RIO NEGRO,2022,3935,3050,885,0.224904701
MS,RIO VERDE DE MATO GROSSO,2022,14579,10777,3802,0.260786062
MS,ROCHEDO,2022,4422,3420,1002,0.226594301
MS,SANTA RITA DO PARDO,2022,5116,3786,1330,0.259968726
MS,SELVÍRIA,2022,6780,5175,1605,0.236725664
MS,SETE QUEDAS,2022,7324,5600,1724,0.235390497
MS,SIDROLÂNDIA,2022,33114,25718,7396,0.223349641
MS,SONORA,2022,11147,8449,2698,0.242038217
MS,SÃO GABRIEL DO OESTE,2022,21720,16556,5164,0.237753223
MS,TACURU,2022,6707,4901,1806,0.269270911
MS,TAQUARUSSU,2022,3541,2815,726,0.205026829
MS,TERENOS,2022,13258,10459,2799,0.211117816
MS,TRÊS LAGOAS,2022,88165,65930,22235,0.252197584
MS,VICENTINA,2022,5705,4695,1010,0.177037686
MS,ÁGUA CLARA,2022,12244,8353,3891,0.317788304
MT,ACORIZAL,2022,6640,5555,1085,0.163403614
MT,ALTA FLORESTA,2022,41569,30793,10776,0.259231639
MT,ALTO ARAGUAIA,2022,12287,9011,3276,0.26662326
MT,ALTO BOA VISTA,2022,4139,2938,1201,0.290166707
MT,ALTO GARÇAS,2022,8274,6230,2044,0.247038917
MT,ALTO PARAGUAI,2022,6124,4642,1482,0.241998694
MT,ALTO TAQUARI,2022,7411,5477,1934,0.260963433
MT,APIACÁS,2022,5717,4271,1446,0.252929858
MT,ARAGUAIANA,2022,3171,2337,834,0.263008515
MT,ARAGUAINHA,2022,1042,834,208,0.199616123
MT,ARAPUTANGA,2022,12049,8762,3287,0.272802722
MT,ARENÁPOLIS,2022,8054,6133,1921,0.238515024
MT,ARIPUANÃ,2022,13988,9357,4631,0.331069488
MT,BARRA DO BUGRES,2022,24100,17923,6177,0.256307054
MT,BARRA DO GARÇAS,2022,47757,34391,13366,0.279875202
MT,BARÃO DE MELGAÇO,2022,6112,4974,1138,0.186191099
MT,BOM JESUS DO ARAGUAIA,2022,5006,3474,1532,0.306032761
MT,BRASNORTE,2022,11831,8364,3467,0.293043699
MT,CAMPINÁPOLIS,2022,10214,7419,2795,0.273644018
MT,CAMPO NOVO DO PARECIS,2022,26883,20002,6881,0.255961016
MT,CAMPO VERDE,2022,31645,24154,7491,0.236719861
MT,CAMPOS DE JÚLIO,2022,5295,3919,1376,0.2598678
MT,CANABRAVA DO NORTE,2022,3697,2603,1094,0.295915607
MT,CANARANA,2022,16403,11801,4602,0.280558434
MT,CARLINDA,2022,7848,5836,2012,0.25637105
MT,CASTANHEIRA,2022,5724,4268,1456,0.254367575
MT,CHAPADA DOS GUIMARÃES,2022,16732,12863,3869,0.231233564
MT,CLÁUDIA,2022,8163,6302,1861,0.227979909
MT,COCALINHO,2022,4815,3231,1584,0.328971963
MT,COLNIZA,2022,17708,12446,5262,0.297153829
MT,COLÍDER,2022,24047,18042,6005,0.2497193
MT,COMODORO,2022,14269,10148,4121,0.288807905
MT,CONFRESA,2022,22080,16181,5899,0.267164855
MT,CONQUISTA D'OESTE,2022,3022,2161,861,0.284910655
MT,COTRIGUAÇU,2022,8518,6211,2307,0.270838225
MT,CUIABÁ,2022,427797,358602,69195,0.161747277
MT,CURVELÂNDIA,2022,4334,3393,941,0.217120443
MT,CÁCERES,2022,66035,47738,18297,0.277080336
MT,DENISE,2022,5626,4508,1118,0.198720228
MT,DIAMANTINO,2022,16407,12499,3908,0.238191016
MT,DOM AQUINO,2022,6340,4856,1484,0.234069401
MT,FELIZ NATAL,2022,6258,4594,1664,0.265899648
MT,FIGUEIRÓPOLIS D'OESTE,2022,3025,2175,850,0.280991736
MT,GAÚCHA DO NORTE,2022,5411,3995,1416,0.261689152
MT,GENERAL CARNEIRO,2022,4123,3107,1016,0.246422508
MT,GLÓRIA D'OESTE,2022,2650,2043,607,0.229056604
MT,GUARANTÃ DO NORTE,2022,22630,16368,6262,0.276712329
MT,GUIRATINGA,2022,8399,6444,1955,0.232765805
MT,INDIAVAÍ,2022,1926,1513,413,0.21443406
MT,IPIRANGA DO NORTE,2022,4841,3702,1139,0.235281967
MT,ITANHANGÁ,2022,5146,3847,1299,0.252429071
MT,ITAÚBA,2022,4232,2976,1256,0.296786389
MT,ITIQUIRA,2022,9145,6690,2455,0.268452706
MT,JACIARA,2022,20129,15681,4448,0.220974713
MT,JANGADA,2022,6935,5579,1356,0.195529921
MT,JAURU,2022,7649,5045,2604,0.340436658
MT,JUARA,2022,24430,17747,6683,0.273557102
MT,JURUENA,2022,6319,4549,1770,0.280107612
MT,JUSCIMEIRA,2022,9272,6929,2343,0.25269629
MT,JUÍNA,2022,33413,24011,9402,0.281387484
MT,LAMBARI D'OESTE,2022,4391,3151,1240,0.28239581
MT,LUCAS DO RIO VERDE,2022,49625,37280,12345,0.248765743
MT,LUCIARA,2022,2189,1673,516,0.235724075
MT,MARCELÂNDIA,2022,8933,6222,2711,0.303481473
MT,MATUPÁ,2022,13241,9790,3451,0.260629862
MT,MIRASSOL D'OESTE,2022,19870,14749,5121,0.257725214
MT,NOBRES,2022,11659,9176,2483,0.212968522
MT,NORTELÂNDIA,2022,4786,3774,1012,0.211450063
MT,NOSSA SENHORA DO LIVRAMENTO,2022,12117,9863,2254,0.186019642
MT,NOVA BANDEIRANTES,2022,9327,6631,2696,0.289053286
MT,NOVA BRASILÂNDIA,2022,3677,2791,886,0.240957302
MT,NOVA CANAÃ DO NORTE,2022,10000,7216,2784,0.2784
MT,NOVA GUARITA,2022,3902,2884,1018,0.26089185
MT,NOVA LACERDA,2022,4615,3121,1494,0.323726977
MT,NOVA MARILÂNDIA,2022,2688,2046,642,0.238839286
MT,NOVA MARINGÁ,2022,4275,3033,1242,0.290526316
MT,NOVA MONTE VERDE,2022,6101,4444,1657,0.271594821
MT,NOVA MUTUM,2022,32416,24823,7593,0.23423618
MT,NOVA NAZARÉ,2022,2754,1794,960,0.348583878
MT,NOVA OLÍMPIA,2022,12517,9409,3108,0.248302309
MT,NOVA SANTA HELENA,2022,2930,2270,660,0.225255973
MT,NOVA UBIRATÃ,2022,7681,5637,2044,0.266111183
MT,NOVA XAVANTINA,2022,16337,11370,4967,0.304033788
MT,NOVO HORIZONTE DO NORTE,2022,3111,2323,788,0.253294761
MT,NOVO MUNDO,2022,5276,3883,1393,0.264025777
MT,NOVO SANTO ANTÔNIO,2022,1850,1285,565,0.305405405
MT,NOVO SÃO JOAQUIM,2022,5324,3901,1423,0.26728024
MT,PARANATINGA,2022,15675,11220,4455,0.284210526
MT,PARANAÍTA,2022,9190,6894,2296,0.249836779
MT,PEDRA PRETA,2022,14219,10694,3525,0.247907729
MT,PEIXOTO DE AZEVEDO,2022,22857,16817,6040,0.264251652
MT,PLANALTO DA SERRA,2022,2655,2036,619,0.233145009
MT,POCONÉ,2022,24030,18333,5697,0.237078652
MT,PONTAL DO ARAGUAIA,2022,4951,3811,1140,0.230256514
MT,PONTE BRANCA,2022,1921,1461,460,0.239458615
MT,PONTES E LACERDA,2022,32235,23483,8752,0.271506127
MT,PORTO ALEGRE DO NORTE,2022,8281,5731,2550,0.307933824
MT,PORTO DOS GAÚCHOS,2022,4011,3023,988,0.246322613
MT,PORTO ESPERIDIÃO,2022,7726,5606,2120,0.274398136
MT,PORTO ESTRELA,2022,3123,2401,722,0.23118796
MT,POXORÉU,2022,14457,9998,4459,0.308431902
MT,PRIMAVERA DO LESTE,2022,50025,39105,10920,0.218290855
MT,QUERÊNCIA,2022,15046,10774,4272,0.283929284
MT,RESERVA DO CABAÇAL,2022,1948,1381,567,0.291067762
MT,RIBEIRÃO CASCALHEIRA,2022,7298,5155,2143,0.293642094
MT,RIBEIRÃOZINHO,2022,2099,1668,431,0.205335874
MT,RIO BRANCO,2022,3976,3029,947,0.238179074
MT,RONDOLÂNDIA,2022,2753,1903,850,0.308754086
MT,RONDONÓPOLIS,2022,166170,128749,37421,0.225197087
MT,ROSÁRIO OESTE,2022,12883,9816,3067,0.238065668
MT,SALTO DO CÉU,2022,2923,2278,645,0.220663702
MT,SANTA CARMEM,2022,3700,2882,818,0.221081081
MT,SANTA CRUZ DO XINGU,2022,1876,1324,552,0.29424307
MT,SANTA RITA DO TRIVELATO,2022,2337,1657,680,0.290971331
MT,SANTA TEREZINHA,2022,4959,3515,1444,0.291187739
MT,SANTO AFONSO,2022,2279,1744,535,0.234752084
MT,SANTO ANTÔNIO DO LESTE,2022,2641,1828,813,0.30783794
MT,SANTO ANTÔNIO DO LEVERGER,2022,16292,13168,3124,0.191750552
MT,SAPEZAL,2022,19096,13313,5783,0.302838291
MT,SERRA NOVA DOURADA,2022,1617,1149,468,0.289424861
MT,SINOP,2022,106940,81652,25288,0.236469048
MT,SORRISO,2022,67362,52318,15044,0.223330661
MT,SÃO FÉLIX DO ARAGUAIA,2022,7681,5207,2474,0.322093477
MT,SÃO JOSÉ DO POVO,2022,2771,2114,657,0.23709852
MT,SÃO JOSÉ DO RIO CLARO,2022,11573,8518,3055,0.263976497
MT,SÃO JOSÉ DO XINGU,2022,4472,2945,1527,0.341457961
MT,SÃO JOSÉ DOS QUATRO MARCOS,2022,14277,10281,3996,0.279890733
MT,SÃO PEDRO DA CIPA,2022,3624,2770,854,0.235651214
MT,TABAPORÃ,2022,7072,5078,1994,0.281957014
MT,TANGARÁ DA SERRA,2022,72256,52760,19496,0.269818423
MT,TAPURAH,2022,9019,6632,2387,0.264663488
MT,TERRA NOVA DO NORTE,2022,8656,6331,2325,0.268599815
MT,TESOURO,2022,2830,2157,673,0.237809187
MT,TORIXORÉU,2022,3427,2700,727,0.212138897
MT,UNIÃO DO SUL,2022,3024,2261,763,0.252314815
MT,VALE DE SÃO DOMINGOS,2022,2655,1942,713,0.268549906
MT,VERA,2022,7162,5316,1846,0.257749232
MT,VILA BELA DA SANTÍSSIMA TRINDADE,2022,10521,7703,2818,0.267845262
MT,VILA RICA,2022,14314,9854,4460,0.311583066
MT,VÁRZEA GRANDE,2022,178509,147139,31370,0.175733436
MT,ÁGUA BOA,2022,19622,14350,5272,0.268678014
PA,ABAETETUBA,2022,119594,99959,19635,0.164180477
PA,ABEL FIGUEIREDO,2022,5470,4247,1223,0.223583181
PA,ACARÁ,2022,44113,37642,6471,0.146691451
PA,AFUÁ,2022,27075,21226,5849,0.216029548
PA,ALENQUER,2022,40975,33153,7822,0.190896888
PA,ALMEIRIM,2022,23689,17745,5944,0.250918148
PA,ALTAMIRA,2022,89576,65323,24253,0.270753327
PA,ANAJÁS,2022,21578,15825,5753,0.266614144
PA,ANANINDEUA,2022,348936,287990,60946,0.174662402
PA,ANAPU,2022,22309,16665,5644,0.252992066
PA,AUGUSTO CORRÊA,2022,35887,28862,7025,0.195753337
PA,AURORA DO PARÁ,2022,19140,14190,4950,0.25862069
PA,AVEIRO,2022,11645,8275,3370,0.28939459
PA,BAGRE,2022,15997,11923,4074,0.254672751
PA,BAIÃO,2022,26547,21205,5342,0.201228011
PA,BANNACH,2022,2948,2220,728,0.246947083
PA,BARCARENA,2022,94687,77908,16779,0.177204896
PA,BELTERRA,2022,15087,12267,2820,0.186915888
PA,BELÉM,2022,1065620,883367,182253,0.171030011
PA,BENEVIDES,2022,46906,38157,8749,0.18652198
PA,BOM JESUS DO TOCANTINS,2022,10901,8713,2188,0.200715531
PA,BONITO,2022,12200,10162,2038,0.16704918
PA,BRAGANÇA,2022,89469,70559,18910,0.211358124
PA,BRASIL NOVO,2022,15183,12198,2985,0.196601462
PA,BREJO GRANDE DO ARAGUAIA,2022,6333,5263,1070,0.168956261
PA,BREU BRANCO,2022,33469,23156,10313,0.308135887
PA,BREVES,2022,73834,55011,18823,0.25493675
PA,BUJARU,2022,21665,17929,3736,0.172444034
PA,CACHOEIRA DO ARARI,2022,18845,14389,4456,0.236455293
PA,CACHOEIRA DO PIRIÁ,2022,14860,10850,4010,0.269851952
PA,CAMETÁ,2022,100371,83950,16421,0.163603033
PA,CANAÃ DOS CARAJÁS,2022,49064,36578,12486,0.254483939
PA,CAPANEMA,2022,53160,43274,9886,0.185966892
PA,CAPITÃO POÇO,2022,41036,34212,6824,0.166293011
PA,CASTANHAL,2022,138488,115062,23426,0.16915545
PA,CHAVES,2022,14514,10290,4224,0.291029351
PA,COLARES,2022,11450,9196,2254,0.196855895
PA,CONCEIÇÃO DO ARAGUAIA,2022,33410,24688,8722,0.261059563
PA,CONCÓRDIA DO PARÁ,2022,23915,19192,4723,0.197491114
PA,CUMARU DO NORTE,2022,7170,5416,1754,0.244630404
PA,CURIONÓPOLIS,2022,17489,12708,4781,0.273371834
PA,CURRALINHO,2022,23461,18602,4859,0.207109671
PA,CURUÁ,2022,10441,8841,1600,0.153242027
PA,CURUÇÁ,2022,33635,26529,7106,0.211268024
PA,DOM ELISEU,2022,30626,23083,7543,0.246293999
PA,ELDORADO DOS CARAJÁS,2022,20707,14974,5733,0.276862897
PA,FARO,2022,6892,5102,1790,0.259721416
PA,FLORESTA DO ARAGUAIA,2022,14097,10909,3188,0.226147407
PA,GARRAFÃO DO NORTE,2022,22763,17262,5501,0.241664104
PA,GOIANÉSIA DO PARÁ,2022,22448,16299,6149,0.273921953
PA,GURUPÁ,2022,21679,17645,4034,0.186078694
PA,IGARAPÉ-AÇU,2022,31555,25266,6289,0.199302805
PA,IGARAPÉ-MIRI,2022,51326,41733,9593,0.186903324
PA,INHANGAPI,2022,8891,7694,1197,0.134630525
PA,IPIXUNA DO PARÁ,2022,24113,17820,6293,0.260979555
PA,IRITUIA,2022,26859,21148,5711,0.212628914
PA,ITAITUBA,2022,87719,60348,27371,0.312030461
PA,ITUPIRANGA,2022,34023,24374,9649,0.283602269
PA,JACAREACANGA,2022,13285,9009,4276,0.321866767
PA,JACUNDÁ,2022,34419,25014,9405,0.27325024
PA,JURUTI,2022,36904,29272,7632,0.20680685
PA,LIMOEIRO DO AJURU,2022,22051,18348,3703,0.167928892
PA,MAGALHÃES BARATA,2022,8409,6712,1697,0.201807587
PA,MARABÁ,2022,185129,142315,42814,0.231265766
PA,MARACANÃ,2022,25327,20955,4372,0.172622103
PA,MARAPANIM,2022,23353,19173,4180,0.178991992
PA,MARITUBA,2022,84772,69879,14893,0.175683009
PA,MEDICILÂNDIA,2022,19943,15429,4514,0.226345083
PA,MELGAÇO,2022,17874,12817,5057,0.282924919
PA,MOCAJUBA,2022,27223,21947,5276,0.193806708
PA,MOJU,2022,55044,44303,10741,0.195134801
PA,MOJUÍ DOS CAMPOS,2022,20289,16121,4168,0.205431515
PA,MONTE ALEGRE,2022,50376,39421,10955,0.217464666
PA,MUANÁ,2022,27831,22120,5711,0.205202831
PA,MÃE DO RIO,2022,26178,19568,6610,0.252502101
PA,NOVA ESPERANÇA DO PIRIÁ,2022,16200,12291,3909,0.241296296
PA,NOVA IPIXUNA,2022,10293,8363,1930,0.187506072
PA,NOVA TIMBOTEUA,2022,11388,9382,2006,0.176150334
PA,NOVO PROGRESSO,2022,23927,16418,7509,0.313829565
PA,NOVO REPARTIMENTO,2022,45781,33371,12410,0.271073153
PA,OEIRAS DO PARÁ,2022,23622,19402,4220,0.178647024
PA,ORIXIMINÁ,2022,48950,36935,12015,0.245454545
PA,OURILÂNDIA DO NORTE,2022,25011,17096,7915,0.316460757
PA,OURÉM,2022,16609,12906,3703,0.222951412
PA,PACAJÁ,2022,28950,21302,7648,0.26417962
PA,PALESTINA DO PARÁ,2022,5588,4617,971,0.173765211
PA,PARAGOMINAS,2022,73912,56673,17239,0.233236822
PA,PARAUAPEBAS,2022,182543,142943,39600,0.216935188
PA,PAU D'ARCO,2022,7754,5531,2223,0.28669074
PA,PEIXE-BOI,2022,8930,7203,1727,0.193393057
PA,PIÇARRA,2022,10066,7300,2766,0.27478641
PA,PLACAS,2022,13670,10530,3140,0.229700073
PA,PONTA DE PEDRAS,2022,21762,17462,4300,0.197592133
PA,PORTEL,2022,38829,27133,11696,0.301218162
PA,PORTO DE MOZ,2022,22784,17377,5407,0.23731566
PA,PRAINHA,2022,25762,20302,5460,0.211940067
PA,PRIMAVERA,2022,10972,8405,2567,0.233959169
PA,QUATIPURU,2022,10208,7526,2682,0.26273511
PA,REDENÇÃO,2022,65286,47915,17371,0.266075422
PA,RIO MARIA,2022,14445,10726,3719,0.257459328
PA,RONDON DO PARÁ,2022,30500,21017,9483,0.310918033
PA,RURÓPOLIS,2022,19498,14276,5222,0.267822341
PA,SALINÓPOLIS,2022,33939,27649,6290,0.185332508
PA,SALVATERRA,2022,19837,15613,4224,0.212935424
PA,SANTA BÁRBARA DO PARÁ,2022,17198,13835,3363,0.195545994
PA,SANTA CRUZ DO ARARI,2022,7098,4693,2405,0.338827839
PA,SANTA ISABEL DO PARÁ,2022,48901,39131,9770,0.199791415
PA,SANTA LUZIA DO PARÁ,2022,17997,13814,4183,0.232427627
PA,SANTA MARIA DAS BARREIRAS,2022,12509,9365,3144,0.251339036
PA,SANTA MARIA DO PARÁ,2022,20689,17353,3336,0.161245106
PA,SANTANA DO ARAGUAIA,2022,25021,17066,7955,0.317932936
PA,SANTARÉM,2022,237660,191329,46331,0.194946562
PA,SANTARÉM NOVO,2022,6309,5286,1023,0.162149311
PA,SANTO ANTÔNIO DO TAUÁ,2022,25480,20238,5242,0.205729984
PA,SAPUCAIA,2022,4856,3717,1139,0.234555189
PA,SENADOR JOSÉ PORFÍRIO,2022,12685,9590,3095,0.243988963
PA,SOURE,2022,22127,17084,5043,0.227911601
PA,SÃO CAETANO DE ODIVELAS,2022,16122,12386,3736,0.231733036
PA,SÃO DOMINGOS DO ARAGUAIA,2022,17084,12165,4919,0.287930227
PA,SÃO DOMINGOS DO CAPIM,2022,23038,19217,3821,0.165856411
PA,SÃO FRANCISCO DO PARÁ,2022,15342,12588,2754,0.179507235
PA,SÃO FÉLIX DO XINGU,2022,42870,30182,12688,0.295964544
PA,SÃO GERALDO DO ARAGUAIA,2022,21411,15140,6271,0.292886834
PA,SÃO JOÃO DA PONTA,2022,5910,4934,976,0.165143824
PA,SÃO JOÃO DE PIRABAS,2022,17623,13727,3896,0.221074732
PA,SÃO JOÃO DO ARAGUAIA,2022,11473,8724,2749,0.239606032
PA,SÃO MIGUEL DO GUAMÁ,2022,41751,33127,8624,0.206557927
PA,SÃO SEBASTIÃO DA BOA VISTA,2022,22418,17828,4590,0.204746186
PA,TAILÂNDIA,2022,52878,40341,12537,0.237092931
PA,TERRA ALTA,2022,10800,8550,2250,0.208333333
PA,TERRA SANTA,2022,14678,10957,3721,0.253508652
PA,TOMÉ-AÇU,2022,52265,39569,12696,0.242915909
PA,TRACUATEUA,2022,24364,19436,4928,0.202265638
PA,TRAIRÃO,2022,11909,8584,3325,0.279200605
PA,TUCUMÃ,2022,28567,20380,8187,0.286589421
PA,TUCURUÍ,2022,75502,55499,20003,0.264933379
PA,ULIANÓPOLIS,2022,20022,14947,5075,0.253471182
PA,URUARÁ,2022,29948,22486,7462,0.24916522
PA,VIGIA,2022,40447,30678,9769,0.241525948
PA,VISEU,2022,45927,33390,12537,0.27297668
PA,VITÓRIA DO XINGU,2022,14736,11641,3095,0.210029859
PA,XINGUARA,2022,37271,26915,10356,0.277856779
PA,ÁGUA AZUL DO NORTE,2022,9799,7641,2158,0.220226554
PA,ÓBIDOS,2022,38364,29945,8419,0.219450527
PB,AGUIAR,2022,4816,3840,976,0.202657807
PB,ALAGOA GRANDE,2022,22125,17317,4808,0.217310734
PB,ALAGOA NOVA,2022,16009,12804,3205,0.200199888
PB,ALAGOINHA,2022,11590,9319,2271,0.19594478
PB,ALCANTIL,2022,4667,4073,594,0.127276623
PB,ALGODÃO DE JANDAÍRA,2022,2993,2429,564,0.188439693
PB,ALHANDRA,2022,18773,15612,3161,0.16838012
PB,AMPARO,2022,2587,2116,471,0.182064167
PB,APARECIDA,2022,6858,5773,1085,0.15820939
PB,ARARA,2022,8910,6851,2059,0.231088664
PB,ARARUNA,2022,13681,10397,3284,0.240040933
PB,ARAÇAGI,2022,13966,11161,2805,0.200844909
PB,AREIA,2022,18462,14841,3621,0.196132597
PB,AREIA DE BARAÚNAS,2022,2156,1789,367,0.170222635
PB,AREIAL,2022,6073,4960,1113,0.183270212
PB,AROEIRAS,2022,15692,12875,2817,0.179518226
PB,ASSUNÇÃO,2022,4143,3320,823,0.198648322
PB,BANANEIRAS,2022,18101,14370,3731,0.206121209
PB,BARAÚNA,2022,4474,3622,852,0.190433616
PB,BARRA DE SANTA ROSA,2022,10682,8678,2004,0.187605317
PB,BARRA DE SANTANA,2022,7428,6153,1275,0.171647819
PB,BARRA DE SÃO MIGUEL,2022,5679,4928,751,0.132241592
PB,BAYEUX,2022,73291,62783,10508,0.143373675
PB,BAÍA DA TRAIÇÃO,2022,7364,6132,1232,0.16730038
PB,BELÉM,2022,13097,10329,2768,0.21134611
PB,BELÉM DO BREJO DO CRUZ,2022,6322,5071,1251,0.197880418
PB,BERNARDINO BATISTA,2022,3166,2448,718,0.226784586
PB,BOA VENTURA,2022,5331,4069,1262,0.236728569
PB,BOA VISTA,2022,5924,5232,692,0.116812964
PB,BOM JESUS,2022,3051,2513,538,0.176335628
PB,BOM SUCESSO,2022,4528,3794,734,0.162102473
PB,BONITO DE SANTA FÉ,2022,7578,6014,1564,0.206386909
PB,BOQUEIRÃO,2022,15043,12402,2641,0.175563385
PB,BORBOREMA,2022,4549,3571,978,0.214992306
PB,BREJO DO CRUZ,2022,10302,8400,1902,0.184624345
PB,BREJO DOS SANTOS,2022,5814,4909,905,0.155658755
PB,CAAPORÃ,2022,16346,13753,2593,0.158632081
PB,CABACEIRAS,2022,4882,4188,694,0.142154855
PB,CABEDELO,2022,51041,40952,10089,0.197664623
PB,CACHOEIRA DOS ÍNDIOS,2022,7744,6207,1537,0.19847624
PB,CACIMBA DE AREIA,2022,3952,3219,733,0.185475709
PB,CACIMBA DE DENTRO,2022,13857,10644,3213,0.23186837
PB,CACIMBAS,2022,6279,4660,1619,0.257843606
PB,CAIÇARA,2022,6253,4894,1359,0.217335679
PB,CAJAZEIRAS,2022,45912,38305,7607,0.165686531
PB,CAJAZEIRINHAS,2022,3863,3087,776,0.200880145
PB,CALDAS BRANDÃO,2022,5282,4413,869,0.164521015
PB,CAMALAÚ,2022,5985,4916,1069,0.1786132
PB,CAMPINA GRANDE,2022,296494,256378,40116,0.13530122
PB,CAPIM,2022,6515,5203,1312,0.201381427
PB,CARAÚBAS,2022,4162,3589,573,0.137674195
PB,CARRAPATEIRA,2022,2302,1814,488,0.211989574
PB,CASSERENGUE,2022,6014,4671,1343,0.223312271
PB,CATINGUEIRA,2022,5314,4051,1263,0.237674068
PB,CATOLÉ DO ROCHA,2022,21374,18007,3367,0.157527838
PB,CATURITÉ,2022,4944,4256,688,0.139158576
PB,CONCEIÇÃO,2022,14502,11607,2895,0.199627638
PB,CONDADO,2022,5548,4513,1035,0.186553713
PB,CONDE,2022,22651,18785,3866,0.170676791
PB,CONGO,2022,5101,4412,689,0.135071555
PB,COREMAS,2022,12185,9403,2782,0.2283135
PB,COXIXOLA,2022,1901,1601,300,0.157811678
PB,CRUZ DO ESPÍRITO SANTO,2022,15913,13510,2403,0.151008609
PB,CUBATI,2022,6498,5342,1156,0.177900893
PB,CUITEGI,2022,5805,4513,1292,0.222566753
PB,CUITÉ,2022,16959,13556,3403,0.200660416
PB,CUITÉ DE MAMANGUAPE,2022,7080,5560,1520,0.214689266
PB,CURRAL DE CIMA,2022,5738,4634,1104,0.192401534
PB,CURRAL VELHO,2022,2356,1839,517,0.219439728
PB,DAMIÃO,2022,4555,3511,1044,0.229198683
PB,DESTERRO,2022,7388,5878,1510,0.20438549
PB,DIAMANTE,2022,5632,4221,1411,0.25053267
PB,DONA INÊS,2022,9065,7151,1914,0.211141754
PB,DUAS ESTRADAS,2022,3564,2927,637,0.178731762
PB,EMAS,2022,3351,2624,727,0.216950164
PB,ESPERANÇA,2022,24953,20348,4605,0.184546948
PB,FAGUNDES,2022,10068,7968,2100,0.208581645
PB,FREI MARTINHO,2022,2820,2367,453,0.160638298
PB,GADO BRAVO,2022,7506,6228,1278,0.170263789
PB,GUARABIRA,2022,42663,35621,7042,0.16506106
PB,GURINHÉM,2022,11247,9153,2094,0.186182982
PB,GURJÃO,2022,3121,2636,485,0.155398911
PB,IBIARA,2022,5522,4281,1241,0.224737414
PB,IGARACY,2022,5755,4330,1425,0.247610773
PB,IMACULADA,2022,8807,6619,2188,0.248438742
PB,INGÁ,2022,14821,11924,2897,0.195465893
PB,ITABAIANA,2022,18985,15761,3224,0.169818278
PB,ITAPORANGA,2022,17143,13456,3687,0.215073208
PB,ITAPOROROCA,2022,13206,10903,2303,0.174390429
PB,ITATUBA,2022,8456,6970,1486,0.175733207
PB,JACARAÚ,2022,13814,10587,3227,0.233603591
PB,JERICÓ,2022,6893,5477,1416,0.205425794
PB,JOCA CLAUDINO,2022,2557,1994,563,0.220179898
PB,JOÃO PESSOA,2022,559205,474496,84709,0.151481121
PB,JUAREZ TÁVORA,2022,7405,6149,1256,0.169615125
PB,JUAZEIRINHO,2022,13293,10720,2573,0.193560521
PB,JUNCO DO SERIDÓ,2022,5683,4729,954,0.167869083
PB,JURIPIRANGA,2022,9745,8145,1600,0.164186762
PB,JURU,2022,7732,6028,1704,0.220382825
PB,LAGOA,2022,4779,3755,1024,0.214270768
PB,LAGOA DE DENTRO,2022,7230,5591,1639,0.226694329
PB,LAGOA SECA,2022,20643,17619,3024,0.146490336
PB,LASTRO,2022,4243,3513,730,0.172048079
PB,LIVRAMENTO,2022,5840,4598,1242,0.212671233
PB,LOGRADOURO,2022,4001,3363,638,0.159460135
PB,LUCENA,2022,12426,10064,2362,0.190085305
PB,MALTA,2022,5181,4114,1067,0.205944798
PB,MAMANGUAPE,2022,32590,26830,5760,0.176741332
PB,MANAÍRA,2022,8662,6752,1910,0.220503348
PB,MARCAÇÃO,2022,6957,5824,1133,0.162857554
PB,MARI,2022,17162,14592,2570,0.149749446
PB,MARIZÓPOLIS,2022,6106,5166,940,0.153946937
PB,MASSARANDUBA,2022,11720,9736,1984,0.169283276
PB,MATARACA,2022,8491,6548,1943,0.228830526
PB,MATINHAS,2022,4508,3588,920,0.204081633
PB,MATO GROSSO,2022,3241,2362,879,0.271212589
PB,MATURÉIA,2022,5510,4339,1171,0.212522686
PB,MOGEIRO,2022,10679,8759,1920,0.179792115
PB,MONTADAS,2022,4863,4112,751,0.154431421
PB,MONTE HOREBE,2022,3994,3046,948,0.237356034
PB,MONTEIRO,2022,25791,21217,4574,0.177348688
PB,MULUNGU,2022,8907,7495,1412,0.158527001
PB,MÃE D'ÁGUA,2022,3772,3078,694,0.183987275
PB,NATUBA,2022,6591,5355,1236,0.187528448
PB,NAZAREZINHO,2022,6840,5722,1118,0.163450292
PB,NOVA FLORESTA,2022,8000,6298,1702,0.21275
PB,NOVA OLINDA,2022,5553,3948,1605,0.289032955
PB,NOVA PALMEIRA,2022,3382,2934,448,0.132465996
PB,OLHO D'ÁGUA,2022,6999,5340,1659,0.237033862
PB,OLIVEDOS,2022,3949,3288,661,0.167384148
PB,OURO VELHO,2022,2909,2500,409,0.140598144
PB,PARARI,2022,2163,1804,359,0.165973185
PB,PASSAGEM,2022,2652,2086,566,0.213423831
PB,PATOS,2022,66980,55275,11705,0.174753658
PB,PAULISTA,2022,9910,8154,1756,0.177194753
PB,PEDRA BRANCA,2022,3942,3006,936,0.237442922
PB,PEDRA LAVRADA,2022,5951,5057,894,0.150226853
PB,PEDRAS DE FOGO,2022,23716,19379,4337,0.182872322
PB,PEDRO RÉGIS,2022,5435,4012,1423,0.261821527
PB,PIANCÓ,2022,12715,10055,2660,0.20920173
PB,PICUÍ,2022,14788,12295,2493,0.168582635
PB,PILAR,2022,9889,8377,1512,0.152897158
PB,PILÕES,2022,6943,5422,1521,0.219069566
PB,PILÕEZINHOS,2022,5264,4249,1015,0.192819149
PB,PIRPIRITUBA,2022,7701,6187,1514,0.196597844
PB,PITIMBU,2022,12043,9886,2157,0.179108196
PB,POCINHOS,2022,14055,11553,2502,0.178014941
PB,POMBAL,2022,25164,20239,4925,0.195716102
PB,POÇO DANTAS,2022,4062,3091,971,0.239044806
PB,POÇO DE JOSÉ DE MOURA,2022,3916,3208,708,0.180796731
PB,PRATA,2022,4037,3355,682,0.16893733
PB,PRINCESA ISABEL,2022,16137,12626,3511,0.217574518
PB,PUXINANÃ,2022,12016,10293,1723,0.143392144
PB,QUEIMADAS,2022,34745,29084,5661,0.162929918
PB,QUIXABA,2022,2288,1964,324,0.141608392
PB,REMÍGIO,2022,14207,11356,2851,0.200675723
PB,RIACHO DE SANTO ANTÔNIO,2022,2404,2083,321,0.133527454
PB,RIACHO DOS CAVALOS,2022,7637,6535,1102,0.144297499
PB,RIACHÃO,2022,3204,2496,708,0.220973783
PB,RIACHÃO DO BACAMARTE,2022,4478,3755,723,0.161456007
PB,RIACHÃO DO POÇO,2022,4368,3693,675,0.154532967
PB,RIO TINTO,2022,18201,15713,2488,0.136695786
PB,SALGADINHO,2022,3283,2565,718,0.218702406
PB,SALGADO DE SÃO FÉLIX,2022,9680,7812,1868,0.192975207
PB,SANTA CECÍLIA,2022,6643,5813,830,0.12494355
PB,SANTA CRUZ,2022,5589,4632,957,0.1712292
PB,SANTA HELENA,2022,5589,4606,983,0.175881195
PB,SANTA INÊS,2022,3818,3022,796,0.208486118
PB,SANTA LUZIA,2022,11819,10013,1806,0.152804806
PB,SANTA RITA,2022,98394,82697,15697,0.159532085
PB,SANTA TERESINHA,2022,5568,4584,984,0.176724138
PB,SANTANA DE MANGUEIRA,2022,4463,3517,946,0.211965046
PB,SANTANA DOS GARROTES,2022,6282,4760,1522,0.242279529
PB,SANTO ANDRÉ,2022,2946,2366,580,0.196877122
PB,SAPÉ,2022,36143,30204,5939,0.164319509
PB,SERRA BRANCA,2022,10432,8439,1993,0.191046779
PB,SERRA DA RAIZ,2022,3036,2455,581,0.191370224
PB,SERRA GRANDE,2022,3204,2464,740,0.230961298
PB,SERRA REDONDA,2022,6178,5200,978,0.158303658
PB,SERRARIA,2022,4389,3370,1019,0.232171337
PB,SERTÃOZINHO,2022,4350,3552,798,0.183448276
PB,SOBRADO,2022,7248,5968,1280,0.176600442
PB,SOLEDADE,2022,11177,9206,1971,0.176344278
PB,SOLÂNEA,2022,21395,16929,4466,0.20874036
PB,SOSSÊGO,2022,3332,2767,565,0.169567827
PB,SOUSA,2022,46662,39549,7113,0.152436672
PB,SUMÉ,2022,13552,11104,2448,0.180637544
PB,SÃO BENTINHO,2022,3804,3021,783,0.205835962
PB,SÃO BENTO,2022,27046,22647,4399,0.162648821
PB,SÃO DOMINGOS,2022,3213,2591,622,0.193588547
PB,SÃO DOMINGOS DO CARIRI,2022,3039,2430,609,0.200394867
PB,SÃO FRANCISCO,2022,4007,3451,556,0.138757175
PB,SÃO JOSÉ DA LAGOA TAPADA,2022,6603,5441,1162,0.175980615
PB,SÃO JOSÉ DE CAIANA,2022,5340,3949,1391,0.260486891
PB,SÃO JOSÉ DE ESPINHARAS,2022,4340,3537,803,0.185023041
PB,SÃO JOSÉ DE PIRANHAS,2022,15138,12262,2876,0.189985467
PB,SÃO JOSÉ DE PRINCESA,2022,3214,2631,583,0.181393902
PB,SÃO JOSÉ DO BONFIM,2022,4041,3362,679,0.168027716
PB,SÃO JOSÉ DO BREJO DO CRUZ,2022,2200,1889,311,0.141363636
PB,SÃO JOSÉ DO SABUGI,2022,4074,3677,397,0.097447226
PB,SÃO JOSÉ DOS CORDEIROS,2022,3464,2784,680,0.19630485
PB,SÃO JOSÉ DOS RAMOS,2022,5544,4466,1078,0.194444444
PB,SÃO JOÃO DO CARIRI,2022,4211,3511,700,0.166231299
PB,SÃO JOÃO DO RIO DO PEIXE,2022,13927,11699,2228,0.159977023
PB,SÃO JOÃO DO TIGRE,2022,3874,3217,657,0.169592153
PB,SÃO MAMEDE,2022,7019,5586,1433,0.204160137
PB,SÃO MIGUEL DE TAIPU,2022,6090,5082,1008,0.165517241
PB,SÃO SEBASTIÃO DE LAGOA DE ROÇA,2022,8779,6966,1813,0.206515548
PB,SÃO SEBASTIÃO DO UMBUZEIRO,2022,3135,2570,565,0.180223285
PB,SÃO VICENTE DO SERIDÓ,2022,8956,7062,1894,0.211478339
PB,TACIMA,2022,7476,5981,1495,0.199973248
PB,TAPEROÁ,2022,11031,8429,2602,0.2358807
PB,TAVARES,2022,11555,8631,2924,0.253050627
PB,TEIXEIRA,2022,11698,9469,2229,0.190545392
PB,TENÓRIO,2022,2890,2452,438,0.151557093
PB,TRIUNFO,2022,7420,5887,1533,0.206603774
PB,UIRAÚNA,2022,12006,10034,1972,0.164251208
PB,UMBUZEIRO,2022,6829,5526,1303,0.190803924
PB,VIEIRÓPOLIS,2022,5014,4079,935,0.186477862
PB,VISTA SERRANA,2022,3257,2503,754,0.231501382
PB,VÁRZEA,2022,2575,2240,335,0.130097087
PB,ZABELÊ,2022,2388,1933,455,0.190536013
PB,ÁGUA BRANCA,2022,7853,6194,1659,0.211256845
PE,ABREU E LIMA,2022,84193,69050,15143,0.179860558
PE,AFOGADOS DA INGAZEIRA,2022,28558,22506,6052,0.211919602
PE,AFRÂNIO,2022,17280,13816,3464,0.200462963
PE,AGRESTINA,2022,19673,16474,3199,0.162608651
PE,ALAGOINHA,2022,12721,9959,2762,0.217121295
PE,ALIANÇA,2022,28735,22124,6611,0.230067861
PE,ALTINHO,2022,16690,13852,2838,0.170041941
PE,AMARAJI,2022,16894,13551,3343,0.197880904
PE,ANGELIM,2022,9384,6957,2427,0.258631714
PE,ARARIPINA,2022,58765,46271,12494,0.212609546
PE,ARAÇOIABA,2022,16155,13849,2306,0.142742185
PE,ARCOVERDE,2022,49020,40388,8632,0.176091391
PE,BARRA DE GUABIRABA,2022,9832,8367,1465,0.149003255
PE,BARREIROS,2022,30897,23555,7342,0.237628249
PE,BELO JARDIM,2022,62321,48957,13364,0.214438151
PE,BELÉM DE MARIA,2022,9661,7646,2015,0.208570541
PE,BELÉM DO SÃO FRANCISCO,2022,15150,12220,2930,0.19339934
PE,BETÂNIA,2022,10511,7452,3059,0.291028446
PE,BEZERROS,2022,46509,39279,7230,0.155453783
PE,BODOCÓ,2022,25376,20673,4703,0.185332598
PE,BOM CONSELHO,2022,37539,26228,11311,0.301313301
PE,BOM JARDIM,2022,29850,23979,5871,0.196683417
PE,BONITO,2022,30420,24525,5895,0.193786982
PE,BREJINHO,2022,7841,5773,2068,0.26374187
PE,BREJO DA MADRE DE DEUS,2022,33631,26450,7181,0.213523237
PE,BREJÃO,2022,9054,7393,1661,0.183454827
PE,BUENOS AIRES,2022,11293,9303,1990,0.176215355
PE,BUÍQUE,2022,39848,28205,11643,0.292185304
PE,CABO DE SANTO AGOSTINHO,2022,160540,136417,24123,0.150261617
PE,CABROBÓ,2022,25947,20248,5699,0.219640035
PE,CACHOEIRINHA,2022,16019,12916,3103,0.193707472
PE,CAETÉS,2022,19989,14709,5280,0.26414528
PE,CALUMBI,2022,6598,5295,1303,0.197484086
PE,CALÇADO,2022,7451,6289,1162,0.155952221
PE,CAMARAGIBE,2022,120503,104596,15907,0.132005012
PE,CAMOCIM DE SÃO FÉLIX,2022,14883,12337,2546,0.171067661
PE,CAMUTANGA,2022,7443,5886,1557,0.209189843
PE,CANHOTINHO,2022,17016,13535,3481,0.204572167
PE,CAPOEIRAS,2022,16108,11801,4307,0.267382667
PE,CARNAUBEIRA DA PENHA,2022,12200,9118,3082,0.252622951
PE,CARNAÍBA,2022,15932,12311,3621,0.227278433
PE,CARPINA,2022,56225,48341,7884,0.140222321
PE,CARUARU,2022,239299,204949,34350,0.143544269
PE,CASINHAS,2022,11761,9314,2447,0.208060539
PE,CATENDE,2022,25578,19702,5876,0.229728673
PE,CEDRO,2022,9944,7546,2398,0.241150442
PE,CHÃ DE ALEGRIA,2022,11057,9249,1808,0.163516325
PE,CHÃ GRANDE,2022,18885,15452,3433,0.181784485
PE,CONDADO,2022,20811,15827,4984,0.239488732
PE,CORRENTES,2022,13891,9733,4158,0.299330502
PE,CORTÊS,2022,10897,8430,2467,0.226392585
PE,CUMARU,2022,15343,11802,3541,0.230789285
PE,CUPIRA,2022,19659,15826,3833,0.194974312
PE,CUSTÓDIA,2022,28603,21450,7153,0.250078663
PE,DORMENTES,2022,16349,12950,3399,0.207902624
PE,ESCADA,2022,47402,39361,8041,0.169634193
PE,EXU,2022,27669,21368,6301,0.227727782
PE,FEIRA NOVA,2022,18399,14584,3815,0.207348225
PE,FERNANDO DE NORONHA,2022,3362,2361,1001,0.297739441
PE,FERREIROS,2022,9958,8099,1859,0.186684073
PE,FLORES,2022,16264,12619,3645,0.224114609
PE,FLORESTA,2022,23986,18978,5008,0.20878846
PE,FREI MIGUELINHO,2022,11974,10253,1721,0.143728078
PE,GAMELEIRA,2022,15333,11771,3562,0.232309398
PE,GARANHUNS,2022,95768,78742,17026,0.177783811
PE,GLÓRIA DO GOITÁ,2022,22630,18558,4072,0.179938135
PE,GOIANA,2022,61100,52399,8701,0.142405892
PE,GRANITO,2022,6732,5631,1101,0.163547237
PE,GRAVATÁ,2022,68958,54313,14645,0.212375649
PE,IATI,2022,15936,11048,4888,0.306726908
PE,IBIMIRIM,2022,20859,15433,5426,0.260127523
PE,IBIRAJUBA,2022,6930,5468,1462,0.210966811
PE,IGARASSU,2022,85872,72748,13124,0.152832122
PE,IGUARACY,2022,8870,7042,1828,0.206087937
PE,ILHA DE ITAMARACÁ,2022,17552,14028,3524,0.20077484
PE,INAJÁ,2022,14295,11076,3219,0.225183631
PE,INGAZEIRA,2022,4074,3397,677,0.166175749
PE,IPOJUCA,2022,80766,67065,13701,0.169638214
PE,IPUBI,2022,22650,16862,5788,0.255540839
PE,ITACURUBA,2022,4351,3599,752,0.172833831
PE,ITAMBÉ,2022,23859,19170,4689,0.196529611
PE,ITAPETIM,2022,12451,9420,3031,0.243434262
PE,ITAPISSUMA,2022,18973,16370,2603,0.137194961
PE,ITAQUITINGA,2022,14012,10794,3218,0.229660291
PE,ITAÍBA,2022,19649,14734,4915,0.250139956
PE,JABOATÃO DOS GUARARAPES,2022,478789,387892,90897,0.18984772
PE,JAQUEIRA,2022,9965,7043,2922,0.293226292
PE,JATAÚBA,2022,14817,11520,3297,0.222514679
PE,JATOBÁ,2022,10789,8361,2428,0.225044026
PE,JOAQUIM NABUCO,2022,13574,10124,3450,0.254162369
PE,JOÃO ALFREDO,2022,25359,18862,6497,0.256200954
PE,JUCATI,2022,9806,8000,1806,0.184172955
PE,JUPI,2022,12325,10141,2184,0.177200811
PE,JUREMA,2022,12141,9201,2940,0.242154682
PE,LAGOA DE ITAENGA,2022,18606,14812,3794,0.203912716
PE,LAGOA DO CARRO,2022,14340,12394,1946,0.135704324
PE,LAGOA DO OURO,2022,11116,8480,2636,0.23713566
PE,LAGOA DOS GATOS,2022,12250,9129,3121,0.25477551
PE,LAGOA GRANDE,2022,21229,16114,5115,0.240943992
PE,LAJEDO,2022,29996,24732,5264,0.175490065
PE,LIMOEIRO,2022,44559,37227,7332,0.164545883
PE,MACAPARANA,2022,19885,15198,4687,0.235705306
PE,MACHADOS,2022,10678,8596,2082,0.194980333
PE,MANARI,2022,13356,9607,3749,0.280697814
PE,MARAIAL,2022,9427,6379,3048,0.323326615
PE,MIRANDIBA,2022,11660,9032,2628,0.225385935
PE,MOREILÂNDIA,2022,9658,7527,2131,0.220646097
PE,MORENO,2022,48069,40094,7975,0.165907342
PE,NAZARÉ DA MATA,2022,25374,21087,4287,0.168952471
PE,OLINDA,2022,297800,258606,39194,0.13161182
PE,OROBÓ,2022,20687,14760,5927,0.286508435
PE,OROCÓ,2022,12540,9658,2882,0.229824561
PE,OURICURI,2022,50751,37294,13457,0.265157337
PE,PALMARES,2022,40521,31576,8945,0.220749735
PE,PALMEIRINA,2022,6651,4498,2153,0.32371072
PE,PANELAS,2022,22030,15535,6495,0.294825238
PE,PARANATAMA,2022,10831,8814,2017,0.186224725
PE,PARNAMIRIM,2022,18133,14493,3640,0.200738984
PE,PASSIRA,2022,25634,20765,4869,0.189943044
PE,PAUDALHO,2022,46069,37036,9033,0.196075452
PE,PAULISTA,2022,228366,195658,32708,0.143226225
PE,PEDRA,2022,19556,14657,4899,0.250511352
PE,PESQUEIRA,2022,50776,38295,12481,0.245805105
PE,PETROLINA,2022,229925,190571,39354,0.171160161
PE,PETROLÂNDIA,2022,25393,19484,5909,0.232701926
PE,POMBOS,2022,19151,16723,2428,0.126781891
PE,POÇÃO,2022,10150,7853,2297,0.226305419
PE,PRIMAVERA,2022,11447,8756,2691,0.235083428
PE,QUIPAPÁ,2022,17914,11555,6359,0.354973764
PE,QUIXABA,2022,6117,4969,1148,0.187673696
PE,RECIFE,2022,1215546,1043107,172439,0.141861353
PE,RIACHO DAS ALMAS,2022,19656,17196,2460,0.125152625
PE,RIBEIRÃO,2022,28236,22427,5809,0.205730273
PE,RIO FORMOSO,2022,16363,12811,3552,0.217075108
PE,SAIRÉ,2022,11024,9541,1483,0.134524673
PE,SALGADINHO,2022,7372,5448,1924,0.26098752
PE,SALGUEIRO,2022,41992,33846,8146,0.193989331
PE,SALOÁ,2022,13513,9346,4167,0.308369718
PE,SANHARÓ,2022,16046,12836,3210,0.200049857
PE,SANTA CRUZ,2022,12412,10140,2272,0.183048663
PE,SANTA CRUZ DA BAIXA VERDE,2022,9157,7560,1597,0.174402097
PE,SANTA CRUZ DO CAPIBARIBE,2022,61813,53157,8656,0.140035268
PE,SANTA FILOMENA,2022,12458,9530,2928,0.2350297
PE,SANTA MARIA DA BOA VISTA,2022,31029,24091,6938,0.22359728
PE,SANTA MARIA DO CAMBUCÁ,2022,11197,8928,2269,0.202643565
PE,SANTA TEREZINHA,2022,8010,6395,1615,0.201622971
PE,SERRA TALHADA,2022,60340,49095,11245,0.186360623
PE,SERRITA,2022,16167,12228,3939,0.243644461
PE,SERTÂNIA,2022,26221,19415,6806,0.259562946
PE,SIRINHAÉM,2022,28418,22300,6118,0.215286086
PE,SOLIDÃO,2022,5584,4385,1199,0.21472063
PE,SURUBIM,2022,45992,38180,7812,0.169855627
PE,SÃO BENEDITO DO SUL,2022,8857,5879,2978,0.33623123
PE,SÃO BENTO DO UNA,2022,36623,27816,8807,0.240477296
PE,SÃO CAITANO,2022,30216,25386,4830,0.159849087
PE,SÃO JOAQUIM DO MONTE,2022,17353,14070,3283,0.189189189
PE,SÃO JOSÉ DA COROA GRANDE,2022,16216,12265,3951,0.243648249
PE,SÃO JOSÉ DO BELMONTE,2022,26580,20239,6341,0.238562829
PE,SÃO JOSÉ DO EGITO,2022,23156,18630,4526,0.195456901
PE,SÃO JOÃO,2022,18891,14061,4830,0.255677307
PE,SÃO LOURENÇO DA MATA,2022,77682,67299,10383,0.133660307
PE,SÃO VICENTE FÉRRER,2022,14178,11286,2892,0.203977994
PE,TABIRA,2022,20583,16508,4075,0.197978915
PE,TACAIMBÓ,2022,10348,8470,1878,0.181484345
PE,TACARATU,2022,17255,13578,3677,0.213097653
PE,TAMANDARÉ,2022,18267,14655,3612,0.197733618
PE,TAQUARITINGA DO NORTE,2022,20701,17500,3201,0.154630211
PE,TEREZINHA,2022,6645,5031,1614,0.242889391
PE,TERRA NOVA,2022,8224,6947,1277,0.155277237
PE,TIMBAÚBA,2022,42475,33973,8502,0.200164803
PE,TORITAMA,2022,32456,27511,4945,0.152360118
PE,TRACUNHAÉM,2022,11156,9359,1797,0.16107924
PE,TRINDADE,2022,22976,17462,5514,0.239989554
PE,TRIUNFO,2022,11500,9446,2054,0.178608696
PE,TUPANATINGA,2022,18386,12504,5882,0.319917328
PE,TUPARETAMA,2022,8099,6469,1630,0.201259415
PE,VENTUROSA,2022,14501,11259,3242,0.223570788
PE,VERDEJANTE,2022,7865,6412,1453,0.18474253
PE,VERTENTE DO LÉRIO,2022,7751,6300,1451,0.187201651
PE,VERTENTES,2022,16560,13250,3310,0.199879227
PE,VICÊNCIA,2022,22126,17316,4810,0.217391304
PE,VITÓRIA DE SANTO ANTÃO,2022,99320,85030,14290,0.143878373
PE,XEXÉU,2022,10460,7812,2648,0.253154876
PE,ÁGUA PRETA,2022,23319,15730,7589,0.325442772
PE,ÁGUAS BELAS,2022,33251,24139,9112,0.274036871
PI,ACAUÃ,2022,6076,5471,605,0.099572087
PI,AGRICOLÂNDIA,2022,5077,4036,1041,0.205042348
PI,ALAGOINHA DO PIAUÍ,2022,5925,5116,809,0.136540084
PI,ALEGRETE DO PIAUÍ,2022,4358,3482,876,0.201009637
PI,ALTO LONGÁ,2022,12304,10589,1715,0.139385566
PI,ALTOS,2022,33709,29175,4534,0.134504138
PI,ALVORADA DO GURGUÉIA,2022,4405,3617,788,0.178887628
PI,AMARANTE,2022,15144,12107,3037,0.200541469
PI,ANGICAL DO PIAUÍ,2022,6816,5356,1460,0.214201878
PI,ANTÔNIO ALMEIDA,2022,2951,2394,557,0.188749576
PI,ANÍSIO DE ABREU,2022,6924,5764,1160,0.167533218
PI,AROAZES,2022,5585,4481,1104,0.197672337
PI,AROEIRAS DO ITAIM,2022,3684,3329,355,0.096362649
PI,ARRAIAL,2022,4201,3387,814,0.19376339
PI,ASSUNÇÃO DO PIAUÍ,2022,7100,5253,1847,0.260140845
PI,AVELINO LOPES,2022,9277,7325,1952,0.210412849
PI,BAIXA GRANDE DO RIBEIRO,2022,9670,8432,1238,0.128024819
PI,BARRA D'ALCÂNTARA,2022,3403,2671,732,0.21510432
PI,BARRAS,2022,36417,28620,7797,0.214103303
PI,BARREIRAS DO PIAUÍ,2022,3516,2674,842,0.239476678
PI,BARRO DURO,2022,5899,4577,1322,0.224105781
PI,BATALHA,2022,22295,16568,5727,0.256873739
PI,BELA VISTA DO PIAUÍ,2022,3380,3082,298,0.08816568
PI,BELÉM DO PIAUÍ,2022,2967,2577,390,0.131445905
PI,BENEDITINOS,2022,9293,7736,1557,0.167545464
PI,BERTOLÍNIA,2022,4521,3804,717,0.158593232
PI,BETÂNIA DO PIAUÍ,2022,5319,4560,759,0.142695995
PI,BOA HORA,2022,6396,5058,1338,0.209193246
PI,BOCAINA,2022,5221,4581,640,0.122581881
PI,BOM JESUS,2022,18684,15841,2843,0.152162278
PI,BOM PRINCÍPIO DO PIAUÍ,2022,6092,5131,961,0.157747866
PI,BONFIM DO PIAUÍ,2022,4986,4107,879,0.176293622
PI,BOQUEIRÃO DO PIAUÍ,2022,5476,4231,1245,0.227355734
PI,BRASILEIRA,2022,7624,5959,1665,0.218389297
PI,BREJO DO PIAUÍ,2022,3748,3118,630,0.168089648
PI,BURITI DOS LOPES,2022,16471,13636,2835,0.172120697
PI,BURITI DOS MONTES,2022,6428,5545,883,0.137367766
PI,CABECEIRAS DO PIAUÍ,2022,9223,7279,1944,0.210777404
PI,CAJAZEIRAS DO PIAUÍ,2022,3476,2873,603,0.173475259
PI,CAJUEIRO DA PRAIA,2022,6810,5734,1076,0.158002937
PI,CALDEIRÃO GRANDE DO PIAUÍ,2022,4961,4337,624,0.125781093
PI,CAMPINAS DO PIAUÍ,2022,5227,4158,1069,0.204515018
PI,CAMPO ALEGRE DO FIDALGO,2022,4345,3760,585,0.134637514
PI,CAMPO GRANDE DO PIAUÍ,2022,5022,4104,918,0.182795699
PI,CAMPO LARGO DO PIAUÍ,2022,5252,4258,994,0.189261234
PI,CAMPO MAIOR,2022,34765,29297,5468,0.157284625
PI,CANAVIEIRA,2022,3346,2666,680,0.203227735
PI,CANTO DO BURITI,2022,15438,12196,3242,0.210001296
PI,CAPITÃO DE CAMPOS,2022,10134,8027,2107,0.207913953
PI,CAPITÃO GERVÁSIO OLIVEIRA,2022,3643,3114,529,0.145209992
PI,CARACOL,2022,7985,6561,1424,0.178334377
PI,CARAÚBAS DO PIAUÍ,2022,4981,4127,854,0.171451516
PI,CARIDADE DO PIAUÍ,2022,4732,3939,793,0.167582418
PI,CASTELO DO PIAUÍ,2022,16097,12421,3676,0.228365534
PI,CAXINGÓ,2022,5455,4613,842,0.154353804
PI,COCAL,2022,21130,17399,3731,0.176573592
PI,COCAL DE TELHA,2022,4524,3477,1047,0.231432361
PI,COCAL DOS ALVES,2022,5409,4387,1022,0.188944352
PI,COIVARAS,2022,5042,4501,541,0.107298691
PI,COLÔNIA DO GURGUÉIA,2022,5160,4206,954,0.184883721
PI,COLÔNIA DO PIAUÍ,2022,6260,4793,1467,0.234345048
PI,CONCEIÇÃO DO CANINDÉ,2022,4607,3858,749,0.162578685
PI,CORONEL JOSÉ DIAS,2022,4726,4125,601,0.127168853
PI,CORRENTE,2022,20304,16056,4248,0.209219858
PI,CRISTALÂNDIA DO PIAUÍ,2022,5423,4413,1010,0.186243777
PI,CRISTINO CASTRO,2022,7735,6246,1489,0.192501616
PI,CURIMATÁ,2022,8756,7095,1661,0.189698492
PI,CURRAIS,2022,5154,4393,761,0.147652309
PI,CURRAL NOVO DO PIAUÍ,2022,4557,3884,673,0.14768488
PI,CURRALINHOS,2022,4810,4100,710,0.147609148
PI,DEMERVAL LOBÃO,2022,12149,10121,2028,0.166927319
PI,DIRCEU ARCOVERDE,2022,5983,4964,1019,0.170315895
PI,DOM EXPEDITO LOPES,2022,6114,5427,687,0.112365064
PI,DOM INOCÊNCIO,2022,7088,6113,975,0.137556433
PI,DOMINGOS MOURÃO,2022,4176,3345,831,0.198994253
PI,ELESBÃO VELOSO,2022,12733,9868,2865,0.22500589
PI,ELISEU MARTINS,2022,3704,2913,791,0.213552916
PI,ESPERANTINA,2022,30568,23907,6661,0.217907616
PI,FARTURA DO PIAUÍ,2022,4460,3702,758,0.169955157
PI,FLORES DO PIAUÍ,2022,4190,3257,933,0.222673031
PI,FLORESTA DO PIAUÍ,2022,2644,2000,644,0.243570348
PI,FLORIANO,2022,44497,35907,8590,0.193046722
PI,FRANCINÓPOLIS,2022,4360,3381,979,0.224541284
PI,FRANCISCO AYRES,2022,4500,3602,898,0.199555556
PI,FRANCISCO MACEDO,2022,2687,2253,434,0.161518422
PI,FRANCISCO SANTOS,2022,7244,5845,1399,0.193125345
PI,FRONTEIRAS,2022,9414,7740,1674,0.177820268
PI,GEMINIANO,2022,6002,5165,837,0.139453515
PI,GILBUÉS,2022,8094,6492,1602,0.197924388
PI,GUADALUPE,2022,8598,6414,2184,0.254012561
PI,GUARIBAS,2022,4206,3287,919,0.218497385
PI,HUGO NAPOLEÃO,2022,4173,3500,673,0.161274862
PI,ILHA GRANDE,2022,8602,7004,1598,0.185770751
PI,INHUMA,2022,12726,10032,2694,0.211692598
PI,IPIRANGA DO PIAUÍ,2022,7418,6081,1337,0.180237261
PI,ISAÍAS COELHO,2022,6132,5103,1029,0.167808219
PI,ITAINÓPOLIS,2022,9392,7821,1571,0.167270017
PI,ITAUEIRA,2022,8882,7001,1881,0.211776627
PI,JACOBINA DO PIAUÍ,2022,4933,4402,531,0.107642408
PI,JAICÓS,2022,13411,10273,3138,0.233987026
PI,JARDIM DO MULATO,2022,4307,3533,774,0.179707453
PI,JATOBÁ DO PIAUÍ,2022,6189,5312,877,0.141703021
PI,JERUMENHA,2022,4633,3735,898,0.193826894
PI,JOAQUIM PIRES,2022,11451,9241,2210,0.192996245
PI,JOCA MARQUES,2022,4867,3876,991,0.203616191
PI,JOSÉ DE FREITAS,2022,33196,28401,4795,0.144445114
PI,JOÃO COSTA,2022,3311,2799,512,0.154636062
PI,JUAZEIRO DO PIAUÍ,2022,5395,4561,834,0.154587581
PI,JUREMA,2022,4691,3897,794,0.169260286
PI,JÚLIO BORGES,2022,4585,3671,914,0.199345692
PI,LAGOA ALEGRE,2022,7871,6694,1177,0.149536272
PI,LAGOA DE SÃO FRANCISCO,2022,5797,4578,1219,0.21028118
PI,LAGOA DO BARRO DO PIAUÍ,2022,4300,3649,651,0.151395349
PI,LAGOA DO PIAUÍ,2022,4393,3781,612,0.139312543
PI,LAGOA DO SÍTIO,2022,4498,3708,790,0.175633615
PI,LAGOINHA DO PIAUÍ,2022,3124,2516,608,0.194622279
PI,LANDRI SALES,2022,4614,3506,1108,0.240138708
PI,LUIS CORREIA,2022,25682,20835,4847,0.188731407
PI,LUZILÂNDIA,2022,19641,15651,3990,0.203146479
PI,MADEIRO,2022,6435,4785,1650,0.256410256
PI,MANOEL EMÍDIO,2022,4613,3747,866,0.187730327
PI,MARCOLÂNDIA,2022,7431,6362,1069,0.143856816
PI,MARCOS PARENTE,2022,3993,3172,821,0.205609817
PI,MASSAPÊ DO PIAUÍ,2022,5924,4841,1083,0.182815665
PI,MATIAS OLÍMPIO,2022,8725,6603,2122,0.243209169
PI,MIGUEL ALVES,2022,25553,19337,6216,0.243259109
PI,MIGUEL LEÃO,2022,1601,1354,247,0.154278576
PI,MILTON BRANDÃO,2022,6749,5020,1729,0.256186102
PI,MONSENHOR GIL,2022,10002,8425,1577,0.157668466
PI,MONSENHOR HIPÓLITO,2022,6866,5929,937,0.13646956
PI,MONTE ALEGRE DO PIAUÍ,2022,8977,7088,1889,0.210426646
PI,MORRO CABEÇA NO TEMPO,2022,3586,2906,680,0.189626325
PI,MORRO DO CHAPÉU DO PIAUÍ,2022,5506,4211,1295,0.235197966
PI,MURICI DOS PORTELAS,2022,5807,4740,1067,0.183743758
PI,NAZARÉ DO PIAUÍ,2022,6551,5192,1359,0.207449244
PI,NAZÁRIA,2022,11231,9305,1926,0.171489627
PI,NOSSA SENHORA DE NAZARÉ,2022,5424,4612,812,0.149705015
PI,NOSSA SENHORA DOS REMÉDIOS,2022,8190,6776,1414,0.172649573
PI,NOVA SANTA RITA,2022,3827,3359,468,0.122288999
PI,NOVO ORIENTE DO PIAUÍ,2022,5130,4023,1107,0.215789474
PI,NOVO SANTO ANTÔNIO,2022,4372,3731,641,0.146614822
PI,OEIRAS,2022,29775,24178,5597,0.18797649
PI,OLHO D'ÁGUA DO PIAUÍ,2022,2344,1875,469,0.200085324
PI,PADRE MARCOS,2022,6007,4951,1056,0.175794906
PI,PAES LANDIM,2022,3847,3249,598,0.155445802
PI,PAJEÚ DO PIAUÍ,2022,3413,2667,746,0.218576033
PI,PALMEIRA DO PIAUÍ,2022,4443,3719,724,0.16295296
PI,PALMEIRAIS,2022,12320,10121,2199,0.17849026
PI,PAQUETÁ,2022,3855,3414,441,0.114396887
PI,PARNAGUÁ,2022,7261,5713,1548,0.213193775
PI,PARNAÍBA,2022,109882,90732,19150,0.174277862
PI,PASSAGEM FRANCA DO PIAUÍ,2022,3867,2965,902,0.233255754
PI,PATOS DO PIAUÍ,2022,5367,4434,933,0.173840134
PI,PAU D'ARCO DO PIAUÍ,2022,4865,4144,721,0.148201439
PI,PAULISTANA,2022,15948,13345,2603,0.163217958
PI,PAVUSSU,2022,3795,2969,826,0.217654809
PI,PEDRO II,2022,32806,24994,7812,0.238127172
PI,PEDRO LAURENTINO,2022,2725,2365,360,0.132110092
PI,PICOS,2022,52858,45134,7724,0.14612736
PI,PIMENTEIRAS,2022,8897,7274,1623,0.182421041
PI,PIO IX,2022,13939,11678,2261,0.162206758
PI,PIRACURUCA,2022,24233,19563,4670,0.192712417
PI,PIRIPIRI,2022,51674,39013,12661,0.245016836
PI,PORTO,2022,9136,7003,2133,0.233471979
PI,PORTO ALEGRE DO PIAUÍ,2022,2016,1650,366,0.181547619
PI,PRATA DO PIAUÍ,2022,3418,2719,699,0.204505559
PI,QUEIMADA NOVA,2022,6782,5910,872,0.128575641
PI,REDENÇÃO DO GURGUÉIA,2022,6623,5217,1406,0.212290503
PI,REGENERAÇÃO,2022,14026,10600,3426,0.244260659
PI,RIACHO FRIO,2022,4066,3363,703,0.172897196
PI,RIBEIRA DO PIAUÍ,2022,3507,2892,615,0.175363559
PI,RIBEIRO GONÇALVES,2022,5185,4208,977,0.188428158
PI,RIO GRANDE DO PIAUÍ,2022,5206,4203,1003,0.192662313
PI,SANTA CRUZ DO PIAUÍ,2022,5283,4617,666,0.126064736
PI,SANTA CRUZ DOS MILAGRES,2022,3485,2727,758,0.217503587
PI,SANTA FILOMENA,2022,5073,4149,924,0.182140745
PI,SANTA LUZ,2022,4815,4122,693,0.143925234
PI,SANTA ROSA DO PIAUÍ,2022,4558,3503,1055,0.231461167
PI,SANTANA DO PIAUÍ,2022,3995,3417,578,0.144680851
PI,SANTO ANTÔNIO DE LISBOA,2022,5734,4917,817,0.142483432
PI,SANTO ANTÔNIO DOS MILAGRES,2022,1896,1575,321,0.169303797
PI,SANTO INÁCIO DO PIAUÍ,2022,3347,2795,552,0.164923812
PI,SEBASTIÃO BARROS,2022,4234,3485,749,0.176901275
PI,SEBASTIÃO LEAL,2022,3890,3430,460,0.118251928
PI,SIGEFREDO PACHECO,2022,8530,7319,1211,0.141969519
PI,SIMPLÍCIO MENDES,2022,9521,8204,1317,0.138325806
PI,SIMÕES,2022,11517,9400,2117,0.18381523
PI,SOCORRO DO PIAUÍ,2022,4204,3403,801,0.190532826
PI,SUSSUAPARA,2022,6319,5356,963,0.152397531
PI,SÃO BRAZ DO PIAUÍ,2022,3976,3302,674,0.169517103
PI,SÃO FRANCISCO DE ASSIS DO PIAUÍ,2022,4505,3954,551,0.122308546
PI,SÃO FRANCISCO DO PIAUÍ,2022,5970,4625,1345,0.225293132
PI,SÃO FÉLIX DO PIAUÍ,2022,3701,3008,693,0.18724669
PI,SÃO GONÇALO DO GURGUÉIA,2022,2576,2107,469,0.182065217
PI,SÃO GONÇALO DO PIAUÍ,2022,4625,3738,887,0.191783784
PI,SÃO JOSÉ DO DIVINO,2022,4929,4200,729,0.147900183
PI,SÃO JOSÉ DO PEIXE,2022,3217,2502,715,0.222256761
PI,SÃO JOSÉ DO PIAUÍ,2022,5818,4772,1046,0.179786868
PI,SÃO JOÃO DA CANABRAVA,2022,4676,3894,782,0.167236955
PI,SÃO JOÃO DA FRONTEIRA,2022,4956,3989,967,0.19511703
PI,SÃO JOÃO DA SERRA,2022,6601,5253,1348,0.204211483
PI,SÃO JOÃO DA VARJOTA,2022,3940,3178,762,0.193401015
PI,SÃO JOÃO DO ARRAIAL,2022,7099,5704,1395,0.19650655
PI,SÃO JOÃO DO PIAUÍ,2022,15021,12340,2681,0.178483456
PI,SÃO JULIÃO,2022,5281,4390,891,0.168718046
PI,SÃO LOURENÇO DO PIAUÍ,2022,4950,4175,775,0.156565657
PI,SÃO LUIS DO PIAUÍ,2022,2670,2325,345,0.129213483
PI,SÃO MIGUEL DA BAIXA GRANDE,2022,2493,2008,485,0.194544725
PI,SÃO MIGUEL DO FIDALGO,2022,2928,2319,609,0.207991803
PI,SÃO MIGUEL DO TAPUIO,2022,15671,11717,3954,0.25231319
PI,SÃO PEDRO DO PIAUÍ,2022,10996,9105,1891,0.171971626
PI,SÃO RAIMUNDO NONATO,2022,25069,21605,3464,0.138178627
PI,TAMBORIL DO PIAUÍ,2022,2644,2137,507,0.191754917
PI,TANQUE DO PIAUÍ,2022,2427,2012,415,0.170992995
PI,TERESINA,2022,589264,499265,89999,0.152731204
PI,UNIÃO,2022,35687,30103,5584,0.156471544
PI,URUÇUÍ,2022,17455,14382,3073,0.176052707
PI,VALENÇA DO PIAUÍ,2022,16291,13525,2766,0.169786999
PI,VERA MENDES,2022,3340,2772,568,0.17005988
PI,VILA NOVA DO PIAUÍ,2022,2822,2489,333,0.118001417
PI,VÁRZEA BRANCA,2022,4554,3762,792,0.173913043
PI,VÁRZEA GRANDE,2022,3958,3091,867,0.219050025
PI,WALL FERRAZ,2022,3950,3481,469,0.118734177
PI,ÁGUA BRANCA,2022,15314,12712,2602,0.169909886
PR,ABATIÁ,2022,5954,4570,1384,0.232448774
PR,ADRIANÓPOLIS,2022,5454,4303,1151,0.21103777
PR,AGUDOS DO SUL,2022,8009,6642,1367,0.170682982
PR,ALMIRANTE TAMANDARÉ,2022,75204,60045,15159,0.201571725
PR,ALTAMIRA DO PARANÁ,2022,3402,2646,756,0.222222222
PR,ALTO PARANÁ,2022,10853,8314,2539,0.233944531
PR,ALTO PARAÍSO,2022,3003,2282,721,0.24009324
PR,ALTO PIQUIRI,2022,7406,5746,1660,0.224142587
PR,ALTÔNIA,2022,14811,11537,3274,0.221051921
PR,ALVORADA DO SUL,2022,7040,5617,1423,0.202130682
PR,AMAPORÃ,2022,3956,3253,703,0.177704752
PR,AMPÉRE,2022,14929,12209,2720,0.182195726
PR,ANAHY,2022,2697,2192,505,0.187245087
PR,ANDIRÁ,2022,16549,12901,3648,0.22043628
PR,ANTONINA,2022,15484,11898,3586,0.231593903
PR,ANTONIO OLINTO,2022,6660,5397,1263,0.18963964
PR,APUCARANA,2022,94621,75518,19103,0.201889644
PR,ARAPONGAS,2022,82690,67205,15485,0.187265691
PR,ARAPOTI,2022,19337,15020,4317,0.223250763
PR,ARAPUÃ,2022,3210,2639,571,0.17788162
PR,ARARUNA,2022,11257,9014,2243,0.199253798
PR,ARAUCÁRIA,2022,104811,85860,18951,0.180811174
PR,ARIRANHA DO IVAÍ,2022,2325,1923,402,0.172903226
PR,ASSAÍ,2022,12519,9764,2755,0.2200655
PR,ASSIS CHATEAUBRIAND,2022,27824,21823,6001,0.215677113
PR,ASTORGA,2022,20862,16090,4772,0.228741252
PR,ATALAIA,2022,3566,2944,622,0.174425126
PR,BALSA NOVA,2022,11586,9565,2021,0.174434663
PR,BANDEIRANTES,2022,25069,19537,5532,0.220670948
PR,BARBOSA FERRAZ,2022,8889,6716,2173,0.244459444
PR,BARRA DO JACARÉ,2022,2624,2173,451,0.171875
PR,BARRACÃO,2022,7549,6072,1477,0.195655054
PR,BELA VISTA DA CAROBA,2022,2961,2490,471,0.159067882
PR,BELA VISTA DO PARAÍSO,2022,12536,9924,2612,0.208359923
PR,BITURUNA,2022,12098,10059,2039,0.168540255
PR,BOA ESPERANÇA,2022,3830,3143,687,0.179373368
PR,BOA ESPERANÇA DO IGUAÇU,2022,2275,1986,289,0.127032967
PR,BOA VENTURA DE SÃO ROQUE,2022,5047,4189,858,0.170001981
PR,BOA VISTA DA APARECIDA,2022,7009,5436,1573,0.224425738
PR,BOCAIÚVA DO SUL,2022,9728,7604,2124,0.218338816
PR,BOM JESUS DO SUL,2022,3498,2981,517,0.147798742
PR,BOM SUCESSO,2022,5247,4296,951,0.181246427
PR,BOM SUCESSO DO SUL,2022,2998,2514,484,0.161440961
PR,BORRAZÓPOLIS,2022,6644,5292,1352,0.203491872
PR,BRAGANEY,2022,4615,3621,994,0.215384615
PR,BRASILÂNDIA DO SUL,2022,3081,2526,555,0.180136319
PR,CAFEARA,2022,2181,1875,306,0.140302613
PR,CAFELÂNDIA,2022,13293,10755,2538,0.190927556
PR,CAFEZAL DO SUL,2022,4064,3284,780,0.191929134
PR,CALIFÓRNIA,2022,6876,5688,1188,0.172774869
PR,CAMBARÁ,2022,18135,14105,4030,0.222222222
PR,CAMBIRA,2022,6156,5129,1027,0.16682911
PR,CAMBÉ,2022,74167,60096,14071,0.189720496
PR,CAMPINA DA LAGOA,2022,12321,9502,2819,0.228796364
PR,CAMPINA DO SIMÃO,2022,3642,2861,781,0.214442614
PR,CAMPINA GRANDE DO SUL,2022,33402,27085,6317,0.189120412
PR,CAMPO BONITO,2022,3622,2936,686,0.189398123
PR,CAMPO DO TENENTE,2022,6103,5123,980,0.160576766
PR,CAMPO LARGO,2022,91263,74990,16273,0.178308844
PR,CAMPO MAGRO,2022,20105,16577,3528,0.175478737
PR,CAMPO MOURÃO,2022,69057,55906,13151,0.190436885
PR,CANDÓI,2022,11618,9373,2245,0.193234636
PR,CANTAGALO,2022,9192,7119,2073,0.225522193
PR,CAPANEMA,2022,15873,12373,3500,0.220500221
PR,CAPITÃO LEÔNIDAS MARQUES,2022,12380,9394,2986,0.241195477
PR,CARAMBEÍ,2022,16445,13750,2695,0.163879599
PR,CARLÓPOLIS,2022,11918,9181,2737,0.229652626
PR,CASCAVEL,2022,233753,190141,43612,0.186573007
PR,CASTRO,2022,54475,44717,9758,0.17912804
PR,CATANDUVAS,2022,7436,5570,1866,0.250941366
PR,CENTENÁRIO DO SUL,2022,8635,6823,1812,0.20984366
PR,CERRO AZUL,2022,13224,10566,2658,0.200998185
PR,CHOPINZINHO,2022,16685,13569,3116,0.18675457
PR,CIANORTE,2022,57869,45689,12180,0.210475384
PR,CIDADE GAÚCHA,2022,9324,7085,2239,0.24013299
PR,CLEVELÂNDIA,2022,13134,10262,2872,0.218669103
PR,COLOMBO,2022,156027,127085,28942,0.185493536
PR,COLORADO,2022,19324,14852,4472,0.231422066
PR,CONGONHINHAS,2022,6580,5164,1416,0.215197568
PR,CONSELHEIRO MAIRINCK,2022,2985,2395,590,0.197654941
PR,CONTENDA,2022,12821,10695,2126,0.165821699
PR,CORBÉLIA,2022,14364,11428,2936,0.204399889
PR,CORNÉLIO PROCÓPIO,2022,35577,28525,7052,0.19821795
PR,CORONEL DOMINGOS SOARES,2022,5081,3998,1083,0.213147018
PR,CORONEL VIVIDA,2022,17429,14291,3138,0.180044753
PR,CORUMBATAÍ DO SUL,2022,3591,2816,775,0.215817321
PR,CRUZ MACHADO,2022,13630,11262,2368,0.173734409
PR,CRUZEIRO DO IGUAÇU,2022,3630,2996,634,0.174655647
PR,CRUZEIRO DO OESTE,2022,17331,13036,4295,0.247821822
PR,CRUZEIRO DO SUL,2022,4000,3179,821,0.20525
PR,CRUZMALTINA,2022,2833,2173,660,0.232968585
PR,CURITIBA,2022,1413413,1151187,262226,0.185526806
PR,CURIÚVA,2022,10798,8194,2604,0.24115577
PR,CÂNDIDO DE ABREU,2022,11638,9219,2419,0.207853583
PR,CÉU AZUL,2022,9017,7194,1823,0.202173672
PR,DIAMANTE D'OESTE,2022,3809,3007,802,0.210553951
PR,DIAMANTE DO NORTE,2022,4562,3475,1087,0.238272687
PR,DIAMANTE DO SUL,2022,3243,2493,750,0.231267345
PR,DOIS VIZINHOS,2022,32691,26774,5917,0.180997828
PR,DOURADINA,2022,6698,5385,1313,0.196028665
PR,DOUTOR CAMARGO,2022,5114,4142,972,0.190066484
PR,DOUTOR ULYSSES,2022,4873,3993,880,0.180586907
PR,ENGENHEIRO BELTRÃO,2022,10835,8341,2494,0.230179972
PR,ENTRE RIOS DO OESTE,2022,3598,3097,501,0.139244024
PR,ENÉAS MARQUES,2022,5443,4469,974,0.178945435
PR,ESPERANÇA NOVA,2022,2044,1616,428,0.209393346
PR,ESPIGÃO ALTO DO IGUAÇU,2022,4389,3330,1059,0.241285031
PR,FAROL,2022,2751,2284,467,0.169756452
PR,FAXINAL,2022,12670,9713,2957,0.233385951
PR,FAZENDA RIO GRANDE,2022,83629,65498,18131,0.216802784
PR,FERNANDES PINHEIRO,2022,5357,4508,849,0.158484226
PR,FIGUEIRA,2022,6483,5070,1413,0.217954651
PR,FLOR DA SERRA DO SUL,2022,4485,3751,734,0.163656633
PR,FLORAÍ,2022,4439,3748,691,0.15566569
PR,FLORESTA,2022,6972,5717,1255,0.180005737
PR,FLORESTÓPOLIS,2022,9285,7842,1443,0.155411955
PR,FLÓRIDA,2022,2301,1988,313,0.136027814
PR,FORMOSA DO OESTE,2022,6342,4909,1433,0.225953958
PR,FOZ DO IGUAÇU,2022,196153,158683,37470,0.191024353
PR,FOZ DO JORDÃO,2022,4372,3384,988,0.225983532
PR,FRANCISCO ALVES,2022,6057,4695,1362,0.224863794
PR,FRANCISCO BELTRÃO,2022,68622,55518,13104,0.190959168
PR,FÊNIX,2022,4087,3138,949,0.232199657
PR,GENERAL CARNEIRO,2022,8626,6685,1941,0.225017389
PR,GODOY MOREIRA,2022,2738,2153,585,0.213659606
PR,GOIOERÊ,2022,22618,17178,5440,0.240516403
PR,GOIOXIM,2022,5320,4263,1057,0.198684211
PR,GRANDES RIOS,2022,5221,3854,1367,0.261827236
PR,GUAIRAÇÁ,2022,5146,4139,1007,0.19568597
PR,GUAMIRANGA,2022,6468,5558,910,0.140692641
PR,GUAPIRAMA,2022,3735,3053,682,0.182597055
PR,GUAPOREMA,2022,1978,1579,399,0.201718908
PR,GUARACI,2022,4222,3475,747,0.176930365
PR,GUARANIAÇU,2022,11249,8848,2401,0.213441195
PR,GUARAPUAVA,2022,132162,107222,24940,0.188707798
PR,GUARAQUEÇABA,2022,6953,5425,1528,0.219761254
PR,GUARATUBA,2022,28616,22026,6590,0.230290746
PR,GUAÍRA,2022,23543,18453,5090,0.216200144
PR,HONÓRIO SERPA,2022,4290,3547,743,0.173193473
PR,IBAITI,2022,21645,16628,5017,0.231785632
PR,IBEMA,2022,5190,3958,1232,0.237379576
PR,IBIPORÃ,2022,39889,31341,8548,0.214294668
PR,ICARAÍMA,2022,7262,5567,1695,0.233406775
PR,IGUARAÇU,2022,3913,3132,781,0.199591107
PR,IGUATU,2022,2007,1660,347,0.172894868
PR,IMBAÚ,2022,8344,6945,1399,0.167665388
PR,IMBITUVA,2022,23288,19439,3849,0.165278255
PR,INAJÁ,2022,2350,1931,419,0.178297872
PR,INDIANÓPOLIS,2022,3825,3068,757,0.197908497
PR,INÁCIO MARTINS,2022,8154,6777,1377,0.168874172
PR,IPIRANGA,2022,11166,9536,1630,0.145978864
PR,IPORÃ,2022,11973,9435,2538,0.211976948
PR,IRACEMA DO OESTE,2022,2389,1895,494,0.20678108
PR,IRATI,2022,45733,37859,7874,0.172173267
PR,IRETAMA,2022,7991,6143,1848,0.231260168
PR,ITAGUAJÉ,2022,3592,2771,821,0.228563474
PR,ITAIPULÂNDIA,2022,9326,7680,1646,0.176495818
PR,ITAMBARACÁ,2022,5127,3861,1266,0.246928028
PR,ITAMBÉ,2022,5214,4210,1004,0.192558496
PR,ITAPEJARA D'OESTE,2022,9235,7454,1781,0.192853276
PR,ITAPERUÇU,2022,20201,17328,2873,0.142220682
PR,ITAÚNA DO SUL,2022,3055,2226,829,0.271358429
PR,IVAIPORÃ,2022,25536,19799,5737,0.224663221
PR,IVATUBA,2022,2796,2085,711,0.254291845
PR,IVATÉ,2022,5704,4515,1189,0.20845021
PR,IVAÍ,2022,10273,8815,1458,0.141925436
PR,JABOTI,2022,4210,3465,745,0.17695962
PR,JACAREZINHO,2022,29898,23659,6239,0.208676166
PR,JAGUAPITÃ,2022,10592,8295,2297,0.216861782
PR,JAGUARIAÍVA,2022,25672,20787,4885,0.190285136
PR,JANDAIA DO SUL,2022,16389,13549,2840,0.173286961
PR,JANIÓPOLIS,2022,4977,3843,1134,0.227848101
PR,JAPIRA,2022,3728,2962,766,0.205472103
PR,JAPURÁ,2022,7205,5906,1299,0.180291464
PR,JARDIM ALEGRE,2022,9669,7386,2283,0.23611542
PR,JARDIM OLINDA,2022,1237,1057,180,0.145513339
PR,JATAIZINHO,2022,9454,7525,1929,0.204040618
PR,JESUÍTAS,2022,7533,6003,1530,0.203106332
PR,JOAQUIM TÁVORA,2022,9240,7304,1936,0.20952381
PR,JUNDIAÍ DO SUL,2022,2687,2070,617,0.229624116
PR,JURANDA,2022,6302,4978,1324,0.210092034
PR,JUSSARA,2022,5512,4458,1054,0.191219158
PR,KALORÉ,2022,3812,3212,600,0.157397692
PR,LAPA,2022,36406,30251,6155,0.169065539
PR,LARANJAL,2022,4640,3636,1004,0.21637931
PR,LARANJEIRAS DO SUL,2022,24294,19642,4652,0.19148761
PR,LEÓPOLIS,2022,3399,2775,624,0.183583407
PR,LIDIANÓPOLIS,2022,3527,2679,848,0.240430961
PR,LINDOESTE,2022,4980,4002,978,0.196385542
PR,LOANDA,2022,15035,12380,2655,0.176587961
PR,LOBATO,2022,3792,3158,634,0.167194093
PR,LONDRINA,2022,393687,317408,76279,0.193755445
PR,LUIZIANA,2022,5763,4558,1205,0.209092487
PR,LUNARDELLI,2022,4225,3336,889,0.210414201
PR,LUPIONÓPOLIS,2022,3949,3222,727,0.18409724
PR,MALLET,2022,10672,8828,1844,0.172788606
PR,MAMBORÊ,2022,10834,8816,2018,0.186265461
PR,MANDAGUARI,2022,28100,22366,5734,0.20405694
PR,MANDAGUAÇU,2022,19487,14986,4501,0.230974496
PR,MANDIRITUBA,2022,18929,15465,3464,0.18299963
PR,MANFRINÓPOLIS,2022,2970,2473,497,0.167340067
PR,MANGUEIRINHA,2022,13471,10922,2549,0.18922129
PR,MANOEL RIBAS,2022,10619,8769,1850,0.174216028
PR,MARECHAL CÂNDIDO RONDON,2022,41355,33209,8146,0.196977391
PR,MARIA HELENA,2022,4727,3885,842,0.178125661
PR,MARIALVA,2022,30286,23466,6820,0.225186555
PR,MARILENA,2022,6159,4588,1571,0.255073876
PR,MARILUZ,2022,8167,6242,1925,0.235704665
PR,MARILÂNDIA DO SUL,2022,7245,5792,1453,0.200552105
PR,MARINGÁ,2022,294583,235930,58653,0.199105176
PR,MARIPÁ,2022,5110,4269,841,0.164579256
PR,MARIÓPOLIS,2022,5271,4396,875,0.166002656
PR,MARMELEIRO,2022,11507,9518,1989,0.172851308
PR,MARQUINHO,2022,3727,3130,597,0.160182452
PR,MARUMBI,2022,3705,3210,495,0.133603239
PR,MATELÂNDIA,2022,13909,10715,3194,0.229635488
PR,MATINHOS,2022,32260,23421,8839,0.27399256
PR,MATO RICO,2022,3284,2615,669,0.203714982
PR,MAUÁ DA SERRA,2022,7345,5947,1398,0.19033356
PR,MEDIANEIRA,2022,38663,30271,8392,0.217055066
PR,MERCEDES,2022,4787,4108,679,0.14184249
PR,MIRADOR,2022,2171,1686,485,0.223399355
PR,MIRASELVA,2022,1756,1540,216,0.123006834
PR,MISSAL,2022,9344,7741,1603,0.171553938
PR,MOREIRA SALES,2022,9764,7608,2156,0.220811143
PR,MORRETES,2022,13758,10950,2808,0.204099433
PR,MUNHOZ DE MELO,2022,3376,2791,585,0.173281991
PR,NOSSA SENHORA DAS GRAÇAS,2022,3062,2538,524,0.17112998
PR,NOVA ALIANÇA DO IVAÍ,2022,1447,1216,231,0.159640636
PR,NOVA AMÉRICA DA COLINA,2022,3099,2652,447,0.144240077
PR,NOVA AURORA,2022,10127,8263,1864,0.184062407
PR,NOVA CANTU,2022,5913,4769,1144,0.193472011
PR,NOVA ESPERANÇA,2022,21023,15903,5120,0.243542786
PR,NOVA ESPERANÇA DO SUDOESTE,2022,4660,4008,652,0.139914163
PR,NOVA FÁTIMA,2022,6394,4790,1604,0.250860181
PR,NOVA LARANJEIRAS,2022,8001,6455,1546,0.193225847
PR,NOVA LONDRINA,2022,10613,7605,3008,0.283425987
PR,NOVA OLÍMPIA,2022,4896,3930,966,0.197303922
PR,NOVA PRATA DO IGUAÇU,2022,8618,7140,1478,0.171501508
PR,NOVA SANTA BÁRBARA,2022,3607,2860,747,0.207097311
PR,NOVA SANTA ROSA,2022,6909,5938,971,0.140541323
PR,NOVA TEBAS,2022,5762,4680,1082,0.18778202
PR,NOVO ITACOLOMI,2022,2798,2404,394,0.140814868
PR,ORTIGUEIRA,2022,19030,14529,4501,0.236521282
PR,OURIZONA,2022,2858,2319,539,0.188593422
PR,OURO VERDE DO OESTE,2022,4945,4058,887,0.179373104
PR,PAIÇANDU,2022,29023,23052,5971,0.205733384
PR,PALMAS,2022,32197,24108,8089,0.251234587
PR,PALMEIRA,2022,26604,22274,4330,0.16275748
PR,PALMITAL,2022,10882,8504,2378,0.218526006
PR,PALOTINA,2022,25015,20012,5003,0.2
PR,PARANACITY,2022,7879,5997,1882,0.2388628
PR,PARANAGUÁ,2022,105103,85272,19831,0.188681579
PR,PARANAPOEMA,2022,2084,1766,318,0.152591171
PR,PARANAVAÍ,2022,64053,50967,13086,0.204299564
PR,PARAÍSO DO NORTE,2022,9969,7959,2010,0.201625038
PR,PATO BRAGADO,2022,4443,3769,674,0.151699302
PR,PATO BRANCO,2022,65320,51974,13346,0.204317208
PR,PAULA FREITAS,2022,4513,3730,783,0.173498781
PR,PAULO FRONTIN,2022,5532,4718,814,0.14714389
PR,PEABIRU,2022,10579,8147,2432,0.229889404
PR,PEROBAL,2022,5380,4317,1063,0.197583643
PR,PINHAIS,2022,94959,77410,17549,0.184806074
PR,PINHAL DE SÃO BENTO,2022,2212,1939,273,0.123417722
PR,PINHALÃO,2022,5502,4456,1046,0.190112686
PR,PINHÃO,2022,23787,18150,5637,0.236978181
PR,PIRAQUARA,2022,69483,55258,14225,0.204726336
PR,PIRAÍ DO SUL,2022,18840,15174,3666,0.194585987
PR,PITANGA,2022,27181,20948,6233,0.229314595
PR,PITANGUEIRAS,2022,2600,2063,537,0.206538462
PR,PIÊN,2022,10003,8758,1245,0.124462661
PR,PLANALTINA DO PARANÁ,2022,3207,2697,510,0.159027128
PR,PLANALTO,2022,10688,8529,2159,0.202002246
PR,PONTA GROSSA,2022,251970,206465,45505,0.180596896
PR,PONTAL DO PARANÁ,2022,21326,16215,5111,0.239660508
PR,PORECATU,2022,9822,7673,2149,0.218794543
PR,PORTO AMAZONAS,2022,3780,3095,685,0.181216931
PR,PORTO BARREIRO,2022,3112,2611,501,0.160989717
PR,PORTO RICO,2022,2563,2160,403,0.157237612
PR,PORTO VITÓRIA,2022,3154,2552,602,0.190868738
PR,PRADO FERREIRA,2022,3144,2590,554,0.176208651
PR,PRANCHITA,2022,4628,3908,720,0.155574762
PR,PRESIDENTE CASTELO BRANCO,2022,4028,3159,869,0.215739821
PR,PRIMEIRO DE MAIO,2022,8779,7074,1705,0.194213464
PR,PRUDENTÓPOLIS,2022,38777,31717,7060,0.182066689
PR,PÉROLA,2022,9340,7261,2079,0.222591006
PR,PÉROLA D'OESTE,2022,5388,4385,1003,0.186154417
PR,QUARTO CENTENÁRIO,2022,3655,2886,769,0.210396717
PR,QUATIGUÁ,2022,6669,5382,1287,0.192982456
PR,QUATRO BARRAS,2022,16722,13874,2848,0.170314556
PR,QUATRO PONTES,2022,3802,3285,517,0.135981063
PR,QUEDAS DO IGUAÇU,2022,24640,18480,6160,0.25
PR,QUERÊNCIA DO NORTE,2022,7859,6552,1307,0.166306146
PR,QUINTA DO SOL,2022,4367,3423,944,0.216166705
PR,QUITANDINHA,2022,13482,11489,1993,0.147826732
PR,RAMILÂNDIA,2022,3598,2753,845,0.234852696
PR,RANCHO ALEGRE,2022,3130,2534,596,0.190415335
PR,RANCHO ALEGRE D'OESTE,2022,2422,1890,532,0.219653179
PR,REALEZA,2022,14810,11599,3211,0.216812964
PR,REBOUÇAS,2022,11922,10111,1811,0.151904043
PR,RENASCENÇA,2022,5263,4387,876,0.166444993
PR,RESERVA,2022,20517,15682,4835,0.235658235
PR,RESERVA DO IGUAÇU,2022,5383,4183,1200,0.22292402
PR,RIBEIRÃO CLARO,2022,9790,7478,2312,0.236159346
PR,RIBEIRÃO DO PINHAL,2022,10444,7982,2462,0.235733435
PR,RIO AZUL,2022,10891,9494,1397,0.128271049
PR,RIO BOM,2022,2975,2419,556,0.186890756
PR,RIO BONITO DO IGUAÇU,2022,11048,9029,2019,0.182748009
PR,RIO BRANCO DO IVAÍ,2022,3587,2679,908,0.253136326
PR,RIO BRANCO DO SUL,2022,26389,22004,4385,0.166167721
PR,RIO NEGRO,2022,23918,19405,4513,0.188686345
PR,ROLÂNDIA,2022,49289,39183,10106,0.205035606
PR,RONCADOR,2022,8687,7005,1682,0.193622655
PR,RONDON,2022,7425,5877,1548,0.208484848
PR,ROSÁRIO DO IVAÍ,2022,4960,3623,1337,0.269556452
PR,SABÁUDIA,2022,6064,5079,985,0.162434037
PR,SALGADO FILHO,2022,3565,2996,569,0.159607293
PR,SALTO DO ITARARÉ,2022,4292,3452,840,0.195712954
PR,SALTO DO LONTRA,2022,11175,9179,1996,0.178612975
PR,SANTA AMÉLIA,2022,3043,2439,604,0.198488334
PR,SANTA CECÍLIA DO PAVÃO,2022,3072,2470,602,0.195963542
PR,SANTA CRUZ DE MONTE CASTELO,2022,6430,5387,1043,0.162208398
PR,SANTA FÉ,2022,8954,7199,1755,0.196001787
PR,SANTA HELENA,2022,21296,17152,4144,0.194590533
PR,SANTA INÊS,2022,1707,1434,273,0.159929701
PR,SANTA ISABEL DO IVAÍ,2022,6925,5551,1374,0.198411552
PR,SANTA IZABEL DO OESTE,2022,9199,7427,1772,0.192629634
PR,SANTA LÚCIA,2022,3308,2617,691,0.208887545
PR,SANTA MARIA DO OESTE,2022,8795,6492,2303,0.261853326
PR,SANTA MARIANA,2022,9482,7283,2199,0.231913099
PR,SANTA MÔNICA,2022,2713,2195,518,0.190932547
PR,SANTA TEREZA DO OESTE,2022,9428,7588,1840,0.195163343
PR,SANTA TEREZINHA DE ITAIPU,2022,17990,14842,3148,0.174986103
PR,SANTANA DO ITARARÉ,2022,4480,3568,912,0.203571429
PR,SANTO ANTONIO DO CAIUÁ,2022,2342,1858,484,0.206660974
PR,SANTO ANTÔNIO DA PLATINA,2022,32661,25784,6877,0.210556933
PR,SANTO ANTÔNIO DO PARAÍSO,2022,2119,1781,338,0.159509202
PR,SANTO ANTÔNIO DO SUDOESTE,2022,14992,12402,2590,0.172758805
PR,SANTO INÁCIO,2022,4555,3830,725,0.159165752
PR,SAPOPEMA,2022,5374,4168,1206,0.224413844
PR,SARANDI,2022,68592,53316,15276,0.222708188
PR,SAUDADE DO IGUAÇU,2022,5238,4284,954,0.182130584
PR,SENGÉS,2022,13643,10755,2888,0.211683647
PR,SERRANÓPOLIS DO IGUAÇU,2022,4393,3663,730,0.166173458
PR,SERTANEJA,2022,4782,3965,817,0.170849017
PR,SERTANÓPOLIS,2022,13116,10639,2477,0.188853309
PR,SIQUEIRA CAMPOS,2022,15995,12532,3463,0.216505158
PR,SULINA,2022,2819,2390,429,0.152181625
PR,SÃO CARLOS DO IVAÍ,2022,5374,4355,1019,0.189616673
PR,SÃO JERÔNIMO DA SERRA,2022,8446,6447,1999,0.236680085
PR,SÃO JORGE D'OESTE,2022,7867,6778,1089,0.138426338
PR,SÃO JORGE DO IVAÍ,2022,4797,3844,953,0.198665833
PR,SÃO JORGE DO PATROCÍNIO,2022,5142,4139,1003,0.195060288
PR,SÃO JOSÉ DA BOA VISTA,2022,4625,3731,894,0.193297297
PR,SÃO JOSÉ DAS PALMEIRAS,2022,3317,2739,578,0.174253844
PR,SÃO JOSÉ DOS PINHAIS,2022,211775,172121,39654,0.187245898
PR,SÃO JOÃO,2022,8986,7496,1490,0.165813488
PR,SÃO JOÃO DO CAIUÁ,2022,4854,3779,1075,0.221466831
PR,SÃO JOÃO DO IVAÍ,2022,9045,6980,2065,0.22830293
PR,SÃO JOÃO DO TRIUNFO,2022,11253,9537,1716,0.152492669
PR,SÃO MANOEL DO PARANÁ,2022,1976,1622,354,0.179149798
PR,SÃO MATEUS DO SUL,2022,33777,27969,5808,0.171951328
PR,SÃO MIGUEL DO IGUAÇU,2022,22767,17735,5032,0.221021654
PR,SÃO PEDRO DO IGUAÇU,2022,5048,4015,1033,0.204635499
PR,SÃO PEDRO DO IVAÍ,2022,6997,5578,1419,0.202801201
PR,SÃO PEDRO DO PARANÁ,2022,2424,2024,400,0.165016502
PR,SÃO SEBASTIÃO DA AMOREIRA,2022,6743,5365,1378,0.204360077
PR,SÃO TOMÉ,2022,4599,3772,827,0.1798217
PR,TAMARANA,2022,8372,6511,1861,0.222288581
PR,TAMBOARA,2022,4087,3289,798,0.195253242
PR,TAPEJARA,2022,12377,9425,2952,0.238506908
PR,TAPIRA,2022,4742,3752,990,0.20877267
PR,TEIXEIRA SOARES,2022,7852,6486,1366,0.173968416
PR,TELÊMACO BORBA,2022,50816,42098,8718,0.171560139
PR,TERRA BOA,2022,13315,10668,2647,0.198798348
PR,TERRA RICA,2022,11961,9224,2737,0.228827021
PR,TERRA ROXA,2022,13455,10890,2565,0.190635452
PR,TIBAGI,2022,14531,11523,3008,0.207005712
PR,TIJUCAS DO SUL,2022,11975,9889,2086,0.174196242
PR,TOLEDO,2022,104165,85377,18788,0.180367686
PR,TOMAZINA,2022,6486,5197,1289,0.198735739
PR,TRÊS BARRAS DO PARANÁ,2022,9187,7500,1687,0.183629041
PR,TUNAS DO PARANÁ,2022,5270,4161,1109,0.210436433
PR,TUNEIRAS DO OESTE,2022,6930,5242,1688,0.243578644
PR,TUPÃSSI,2022,5993,5162,831,0.138661772
PR,TURVO,2022,11605,9473,2132,0.183713916
PR,UBIRATÃ,2022,19561,15252,4309,0.220285261
PR,UMUARAMA,2022,81501,64351,17150,0.210426866
PR,UNIFLOR,2022,2129,1792,337,0.158290277
PR,UNIÃO DA VITÓRIA,2022,40445,31944,8501,0.210186673
PR,URAÍ,2022,8597,7041,1556,0.18099337
PR,VENTANIA,2022,7292,6138,1154,0.158255623
PR,VERA CRUZ DO OESTE,2022,6933,5396,1537,0.221693351
PR,VERÊ,2022,7026,5951,1075,0.153003131
PR,VIRMOND,2022,3491,2912,579,0.165855056
PR,VITORINO,2022,5727,4500,1227,0.214248298
PR,WENCESLAU BRAZ,2022,14687,11347,3340,0.227411997
PR,XAMBRÊ,2022,5219,4232,987,0.189116689
PR,ÂNGULO,2022,2643,2230,413,0.156261824
RJ,ANGRA DOS REIS,2022,132701,101399,31302,0.235883678
RJ,APERIBÉ,2022,9727,8005,1722,0.177033001
RJ,ARARUAMA,2022,102815,77956,24859,0.241783786
RJ,AREAL,2022,9824,7944,1880,0.191368078
RJ,ARMAÇÃO DOS BÚZIOS,2022,32891,25314,7577,0.23036697
RJ,ARRAIAL DO CABO,2022,33147,24408,8739,0.263643769
RJ,BARRA DO PIRAÍ,2022,70548,54466,16082,0.22795827
RJ,BARRA MANSA,2022,135565,107719,27846,0.205407
RJ,BELFORD ROXO,2022,338714,263601,75113,0.22175936
RJ,BOM JARDIM,2022,22364,17230,5134,0.229565373
RJ,BOM JESUS DO ITABAPOANA,2022,30430,23283,7147,0.234866908
RJ,CABO FRIO,2022,161759,124029,37730,0.233248227
RJ,CACHOEIRAS DE MACACU,2022,45775,35431,10344,0.225974877
RJ,CAMBUCI,2022,12344,9804,2540,0.205767984
RJ,CAMPOS DOS GOYTACAZES,2022,369468,288302,81166,0.219683437
RJ,CANTAGALO,2022,16002,12625,3377,0.21103612
RJ,CARAPEBUS,2022,12875,10116,2759,0.214291262
RJ,CARDOSO MOREIRA,2022,12126,8985,3141,0.259030183
RJ,CARMO,2022,14756,11792,2964,0.200867444
RJ,CASIMIRO DE ABREU,2022,33894,25975,7919,0.233640172
RJ,COMENDADOR LEVY GASPARIAN,2022,8100,6779,1321,0.16308642
RJ,CONCEIÇÃO DE MACABU,2022,17828,13793,4035,0.22632937
RJ,CORDEIRO,2022,17243,13734,3509,0.203502871
RJ,DUAS BARRAS,2022,10006,8072,1934,0.19328403
RJ,DUQUE DE CAXIAS,2022,672121,530263,141858,0.211060211
RJ,ENGENHEIRO PAULO DE FRONTIN,2022,11091,9027,2064,0.186096835
RJ,GUAPIMIRIM,2022,42262,33094,9168,0.216932469
RJ,IGUABA GRANDE,2022,27083,20867,6216,0.229516671
RJ,ITABORAÍ,2022,176127,138370,37757,0.214373719
RJ,ITAGUAÍ,2022,94679,74424,20255,0.213933396
RJ,ITALVA,2022,11722,8845,2877,0.245435932
RJ,ITAOCARA,2022,20263,15955,4308,0.212604254
RJ,ITAPERUNA,2022,75604,57971,17633,0.233228401
RJ,ITATIAIA,2022,25932,20186,5746,0.221579516
RJ,JAPERI,2022,75271,58844,16427,0.2182381
RJ,LAJE DO MURIAÉ,2022,7394,5712,1682,0.227481742
RJ,MACAÉ,2022,172925,131556,41369,0.23923088
RJ,MACUCO,2022,7153,5886,1267,0.177128478
RJ,MAGÉ,2022,197360,155254,42106,0.213346169
RJ,MANGARATIBA,2022,39482,29528,9954,0.252114888
RJ,MARICÁ,2022,143479,114031,29448,0.205242579
RJ,MENDES,2022,15783,12283,3500,0.221757587
RJ,MESQUITA,2022,136389,108811,27578,0.202201057
RJ,MIGUEL PEREIRA,2022,24084,18752,5332,0.221391795
RJ,MIRACEMA,2022,22745,17480,5265,0.231479446
RJ,NATIVIDADE,2022,12872,9988,2884,0.224052206
RJ,NILÓPOLIS,2022,131102,104892,26210,0.199920672
RJ,NITERÓI,2022,405415,327093,78322,0.193189695
RJ,NOVA FRIBURGO,2022,154843,119241,35602,0.229923213
RJ,NOVA IGUAÇU,2022,611833,485558,126275,0.206388018
RJ,PARACAMBI,2022,33968,26851,7117,0.209520725
RJ,PARATY,2022,32746,25221,7525,0.229799059
RJ,PARAÍBA DO SUL,2022,34504,26588,7916,0.229422676
RJ,PATY DO ALFERES,2022,23325,18250,5075,0.217577706
RJ,PETRÓPOLIS,2022,243769,185290,58479,0.239895147
RJ,PINHEIRAL,2022,18114,14527,3587,0.198023628
RJ,PIRAÍ,2022,22982,18099,4883,0.212470629
RJ,PORCIÚNCULA,2022,14469,10672,3797,0.262423111
RJ,PORTO REAL,2022,17737,14369,3368,0.18988555
RJ,QUATIS,2022,10860,8806,2054,0.189134438
RJ,QUEIMADOS,2022,94389,80472,13917,0.147443028
RJ,QUISSAMÃ,2022,19175,14994,4181,0.218044329
RJ,RESENDE,2022,97051,75238,21813,0.224758117
RJ,RIO BONITO,2022,45348,36378,8970,0.197803652
RJ,RIO CLARO,2022,15739,12123,3616,0.22974776
RJ,RIO DAS FLORES,2022,8612,6642,1970,0.228750581
RJ,RIO DAS OSTRAS,2022,92586,73243,19343,0.208919275
RJ,RIO DE JANEIRO,2022,5002621,3792068,1210553,0.241983752
RJ,SANTA MARIA MADALENA,2022,9044,7074,1970,0.217823972
RJ,SANTO ANTÔNIO DE PÁDUA,2022,33343,25283,8060,0.241729898
RJ,SAPUCAIA,2022,16631,12983,3648,0.219349408
RJ,SAQUAREMA,2022,73700,56477,17223,0.233690638
RJ,SEROPÉDICA,2022,58008,46010,11998,0.20683354
RJ,SILVA JARDIM,2022,19626,14915,4711,0.240038724
RJ,SUMIDOURO,2022,14522,11321,3201,0.220424184
RJ,SÃO FIDÉLIS,2022,31987,23845,8142,0.254540907
RJ,SÃO FRANCISCO DE ITABAPOANA,2022,38863,28495,10368,0.266783316
RJ,SÃO GONÇALO,2022,670644,519441,151203,0.225459409
RJ,SÃO JOSÉ DE UBÁ,2022,7364,5952,1412,0.191743618
RJ,SÃO JOSÉ DO VALE DO RIO PRETO,2022,16980,12953,4027,0.237161366
RJ,SÃO JOÃO DA BARRA,2022,38358,30764,7594,0.197976954
RJ,SÃO JOÃO DE MERITI,2022,377405,290116,87289,0.231287344
RJ,SÃO PEDRO DA ALDEIA,2022,69495,54121,15374,0.221224549
RJ,SÃO SEBASTIÃO DO ALTO,2022,7765,6324,1441,0.185576304
RJ,TANGUÁ,2022,25444,20619,4825,0.189632133
RJ,TERESÓPOLIS,2022,129040,99545,29495,0.228572536
RJ,TRAJANO DE MORAES,2022,8757,7149,1608,0.183624529
RJ,TRÊS RIOS,2022,63187,49497,13690,0.21665849
RJ,VALENÇA,2022,57889,42840,15049,0.259963033
RJ,VARRE-SAI,2022,8667,6786,1881,0.217030114
RJ,VASSOURAS,2022,30867,23436,7431,0.240742541
RJ,VOLTA REDONDA,2022,225799,179691,46108,0.20419931
RN,ACARI,2022,9227,7436,1791,0.194104259
RN,AFONSO BEZERRA,2022,9862,8005,1857,0.18829852
RN,ALEXANDRIA,2022,11333,9191,2142,0.189005559
RN,ALMINO AFONSO,2022,5191,4378,813,0.156617222
RN,ALTO DO RODRIGUES,2022,11362,9193,2169,0.19089949
RN,ANGICOS,2022,9863,8201,1662,0.168508567
RN,ANTÔNIO MARTINS,2022,5669,4870,799,0.140941965
RN,APODI,2022,28981,24843,4138,0.142783203
RN,AREIA BRANCA,2022,21339,17182,4157,0.194807629
RN,AREZ,2022,10926,9190,1736,0.158887058
RN,ASSÚ,2022,43450,35819,7631,0.175627158
RN,BARAÚNA,2022,20566,16879,3687,0.179276476
RN,BARCELONA,2022,4639,3774,865,0.1864626
RN,BAÍA FORMOSA,2022,7130,5669,1461,0.204908836
RN,BENTO FERNANDES,2022,4807,4045,762,0.158518827
RN,BOA SAÚDE,2022,7499,6206,1293,0.17242299
RN,BODÓ,2022,3597,2773,824,0.229079789
RN,BOM JESUS,2022,8695,7052,1643,0.188959172
RN,BREJINHO,2022,10066,7965,2101,0.208722432
RN,CAICÓ,2022,44722,37373,7349,0.164326282
RN,CAIÇARA DO NORTE,2022,5185,4309,876,0.168948891
RN,CAIÇARA DO RIO DO VENTO,2022,3659,3143,516,0.141022137
RN,CAMPO GRANDE,2022,8546,7119,1427,0.166978703
RN,CAMPO REDONDO,2022,8250,6823,1427,0.172969697
RN,CANGUARETAMA,2022,24006,19115,4891,0.203740731
RN,CARAÚBAS,2022,19004,15492,3512,0.184803199
RN,CARNAUBAIS,2022,8721,7223,1498,0.171769293
RN,CARNAÚBA DOS DANTAS,2022,5990,5007,983,0.164106845
RN,CEARÁ-MIRIM,2022,56407,46581,9826,0.174198238
RN,CERRO CORÁ,2022,9170,7137,2033,0.2217012
RN,CORONEL EZEQUIEL,2022,4755,3676,1079,0.226919033
RN,CORONEL JOÃO PESSOA,2022,4023,3262,761,0.189162317
RN,CRUZETA,2022,6805,5488,1317,0.193534166
RN,CURRAIS NOVOS,2022,31733,25359,6374,0.200863454
RN,DOUTOR SEVERIANO,2022,5893,4932,961,0.163074835
RN,ENCANTO,2022,4734,3989,745,0.157372201
RN,EQUADOR,2022,4648,3871,777,0.167168675
RN,ESPÍRITO SANTO,2022,7546,6032,1514,0.200636099
RN,EXTREMOZ,2022,28032,23737,4295,0.153217751
RN,FELIPE GUERRA,2022,6687,5857,830,0.12412143
RN,FERNANDO PEDROZA,2022,3133,2694,439,0.140121289
RN,FLORÂNIA,2022,8098,6788,1310,0.161768338
RN,FRANCISCO DANTAS,2022,2791,2317,474,0.169831602
RN,FRUTUOSO GOMES,2022,4103,3369,734,0.178893493
RN,GALINHOS,2022,2562,2164,398,0.155347385
RN,GOIANINHA,2022,21049,17276,3773,0.17924842
RN,GOVERNADOR DIX-SEPT ROSADO,2022,11909,9903,2006,0.168444034
RN,GROSSOS,2022,8757,7562,1195,0.136462259
RN,GUAMARÉ,2022,15283,12173,3110,0.203494078
RN,IELMO MARINHO,2022,10951,9065,1886,0.172221715
RN,IPANGUAÇU,2022,12590,10343,2247,0.17847498
RN,IPUEIRA,2022,2003,1737,266,0.132800799
RN,ITAJÁ,2022,6589,5333,1256,0.190620732
RN,ITAÚ,2022,4953,4098,855,0.172622653
RN,JANDAÍRA,2022,5615,4814,801,0.142653606
RN,JANDUÍS,2022,4350,3606,744,0.171034483
RN,JAPI,2022,5522,4441,1081,0.195762405
RN,JARDIM DE ANGICOS,2022,2839,2460,379,0.13349771
RN,JARDIM DE PIRANHAS,2022,10501,8887,1614,0.153699648
RN,JARDIM DO SERIDÓ,2022,10001,8502,1499,0.149885011
RN,JAÇANÃ,2022,6039,4895,1144,0.189435337
RN,JOSÉ DA PENHA,2022,5215,4255,960,0.184084372
RN,JOÃO CÂMARA,2022,25369,21267,4102,0.161693405
RN,JOÃO DIAS,2022,3175,2518,657,0.206929134
RN,JUCURUTU,2022,15059,12646,2413,0.160236403
RN,JUNDIÁ,2022,4225,3474,751,0.177751479
RN,LAGOA D'ANTA,2022,5682,4619,1063,0.187082013
RN,LAGOA DE PEDRAS,2022,7354,5945,1409,0.19159641
RN,LAGOA DE VELHOS,2022,3200,2610,590,0.184375
RN,LAGOA NOVA,2022,12222,9633,2589,0.211831124
RN,LAGOA SALGADA,2022,9335,7531,1804,0.193251205
RN,LAJES,2022,8827,7222,1605,0.181828481
RN,LAJES PINTADAS,2022,5073,4274,799,0.157500493
RN,LUCRÉCIA,2022,3378,2908,470,0.139135583
RN,LUÍS GOMES,2022,7440,5820,1620,0.217741935
RN,MACAU,2022,22419,17717,4702,0.209732816
RN,MACAÍBA,2022,52343,43388,8955,0.171083048
RN,MAJOR SALES,2022,3084,2570,514,0.166666667
RN,MARCELINO VIEIRA,2022,6738,5704,1034,0.153457999
RN,MARTINS,2022,6929,5672,1257,0.181411459
RN,MAXARANGUAPE,2022,9281,7729,1552,0.16722336
RN,MESSIAS TARGINO,2022,4429,3843,586,0.132309776
RN,MONTANHAS,2022,9108,7318,1790,0.196530523
RN,MONTE ALEGRE,2022,17077,13830,3247,0.190138783
RN,MONTE DAS GAMELEIRAS,2022,2740,2292,448,0.16350365
RN,MOSSORÓ,2022,183285,150013,33272,0.181531495
RN,NATAL,2022,583079,465858,117221,0.201037938
RN,NOVA CRUZ,2022,26548,21342,5206,0.196097634
RN,NÍSIA FLORESTA,2022,21183,17439,3744,0.176745503
RN,OLHO D'ÁGUA DO BORGES,2022,4368,3603,765,0.175137363
RN,OURO BRANCO,2022,4228,3658,570,0.134815516
RN,PARANÁ,2022,4106,3243,863,0.210180224
RN,PARAZINHO,2022,5067,4218,849,0.167554766
RN,PARAÚ,2022,4325,3679,646,0.149364162
RN,PARELHAS,2022,16903,14374,2529,0.149618411
RN,PARNAMIRIM,2022,136655,113392,23263,0.170231605
RN,PASSA E FICA,2022,9275,7672,1603,0.172830189
RN,PASSAGEM,2022,3491,3082,409,0.117158407
RN,PATU,2022,9404,7963,1441,0.153232667
RN,PAU DOS FERROS,2022,20326,17190,3136,0.154285152
RN,PEDRA GRANDE,2022,4027,3345,682,0.169356841
RN,PEDRA PRETA,2022,3218,2711,507,0.157551274
RN,PEDRO AVELINO,2022,6634,4919,1715,0.258516732
RN,PEDRO VELHO,2022,11605,9398,2207,0.190176648
RN,PENDÊNCIAS,2022,10729,8844,1885,0.17569205
RN,PILÕES,2022,3570,2814,756,0.211764706
RN,PORTALEGRE,2022,6379,5440,939,0.147201756
RN,PORTO DO MANGUE,2022,4844,4024,820,0.169281585
RN,POÇO BRANCO,2022,11025,9154,1871,0.169705215
RN,PUREZA,2022,7874,6391,1483,0.188341377
RN,RAFAEL FERNANDES,2022,4813,4097,716,0.148763765
RN,RAFAEL GODEIRO,2022,3786,3010,776,0.204965663
RN,RIACHO DA CRUZ,2022,2788,2382,406,0.145624103
RN,RIACHO DE SANTANA,2022,3750,3140,610,0.162666667
RN,RIACHUELO,2022,6221,5356,865,0.13904517
RN,RIO DO FOGO,2022,9816,8265,1551,0.158007335
RN,RODOLFO FERNANDES,2022,4171,3503,668,0.16015344
RN,RUY BARBOSA,2022,3956,3238,718,0.181496461
RN,SANTA CRUZ,2022,26025,21581,4444,0.170758886
RN,SANTA MARIA,2022,4507,3745,762,0.169070335
RN,SANTANA DO MATOS,2022,11222,9158,2064,0.183924434
RN,SANTANA DO SERIDÓ,2022,2574,2239,335,0.13014763
RN,SANTO ANTÔNIO,2022,17839,14974,2865,0.160603173
RN,SENADOR ELÓI DE SOUZA,2022,5482,4583,899,0.163991244
RN,SENADOR GEORGINO AVELINO,2022,3818,3191,627,0.164222106
RN,SERRA CAIADA,2022,8349,6817,1532,0.183495029
RN,SERRA DE SÃO BENTO,2022,5558,4503,1055,0.189816481
RN,SERRA DO MEL,2022,11211,9718,1493,0.133172777
RN,SERRA NEGRA DO NORTE,2022,6271,5147,1124,0.179237761
RN,SERRINHA,2022,6636,5510,1126,0.16968053
RN,SERRINHA DOS PINTOS,2022,4062,3444,618,0.152141802
RN,SEVERIANO MELO,2022,6669,5597,1072,0.16074374
RN,SÃO BENTO DO NORTE,2022,3715,3081,634,0.170659489
RN,SÃO BENTO DO TRAIRÍ,2022,4224,3348,876,0.207386364
RN,SÃO FERNANDO,2022,3485,3028,457,0.131133429
RN,SÃO FRANCISCO DO OESTE,2022,4016,3257,759,0.188994024
RN,SÃO GONÇALO DO AMARANTE,2022,72923,60992,11931,0.163610932
RN,SÃO JOSÉ DE MIPIBU,2022,32622,26393,6229,0.190944761
RN,SÃO JOSÉ DO CAMPESTRE,2022,10214,8325,1889,0.184942236
RN,SÃO JOSÉ DO SERIDÓ,2022,4347,3770,577,0.13273522
RN,SÃO JOÃO DO SABUGI,2022,5177,4459,718,0.138690361
RN,SÃO MIGUEL,2022,17958,13961,3997,0.222574897
RN,SÃO MIGUEL DO GOSTOSO,2022,8743,7235,1508,0.172480842
RN,SÃO PAULO DO POTENGI,2022,13765,11391,2374,0.1724664
RN,SÃO PEDRO,2022,6031,5077,954,0.158182723
RN,SÃO RAFAEL,2022,7262,6022,1240,0.170751859
RN,SÃO TOMÉ,2022,9644,7491,2153,0.223247615
RN,SÃO VICENTE,2022,5117,4211,906,0.177056869
RN,SÍTIO NOVO,2022,4952,4028,924,0.186591276
RN,TABOLEIRO GRANDE,2022,2799,2423,376,0.134333691
RN,TAIPU,2022,10159,8578,1581,0.155625554
RN,TANGARÁ,2022,12160,9415,2745,0.225740132
RN,TENENTE ANANIAS,2022,7813,6484,1329,0.170101114
RN,TENENTE LAURENTINO CRUZ,2022,5085,4255,830,0.163225172
RN,TIBAU,2022,6623,5353,1270,0.191756002
RN,TIBAU DO SUL,2022,12528,10307,2221,0.177282886
RN,TIMBAÚBA DOS BATISTAS,2022,2584,2175,409,0.158281734
RN,TOUROS,2022,26028,21451,4577,0.175849086
RN,TRIUNFO POTIGUAR,2022,3998,3366,632,0.15807904
RN,UMARIZAL,2022,8620,7063,1557,0.18062645
RN,UPANEMA,2022,11556,9837,1719,0.148753894
RN,VENHA-VER,2022,3879,2952,927,0.238979118
RN,VERA CRUZ,2022,10440,8362,2078,0.199042146
RN,VILA FLOR,2022,3102,2530,572,0.184397163
RN,VIÇOSA,2022,1874,1523,351,0.187299893
RN,VÁRZEA,2022,4763,4088,675,0.141717405
RN,ÁGUA NOVA,2022,2791,2343,448,0.160515944
RO,ALTA FLORESTA D'OESTE,2022,19396,14080,5316,0.274077129
RO,ALTO ALEGRE DOS PARECIS,2022,8354,6463,1891,0.226358631
RO,ALTO PARAÍSO,2022,11716,8598,3118,0.266131786
RO,ALVORADA DO OESTE,2022,11874,8316,3558,0.299646286
RO,ARIQUEMES,2022,70026,51703,18323,0.261659955
RO,BURITIS,2022,22970,15876,7094,0.308837614
RO,CABIXI,2022,4770,3581,1189,0.249266247
RO,CACAULÂNDIA,2022,3934,2976,958,0.243518048
RO,CACOAL,2022,66611,51168,15443,0.231838585
RO,CAMPO NOVO DE RONDÔNIA,2022,7750,5567,2183,0.281677419
RO,CANDEIAS DO JAMARI,2022,18884,13693,5191,0.274888795
RO,CASTANHEIRAS,2022,3077,2297,780,0.253493663
RO,CEREJEIRAS,2022,12945,10044,2901,0.22410197
RO,CHUPINGUAIA,2022,7312,5114,2198,0.300601751
RO,COLORADO DO OESTE,2022,13774,10013,3761,0.273050675
RO,CORUMBIARA,2022,5612,4396,1216,0.216678546
RO,COSTA MARQUES,2022,9506,6884,2622,0.275825794
RO,CUJUBIM,2022,11101,7903,3198,0.288082155
RO,ESPIGÃO DO OESTE,2022,23901,18242,5659,0.236768336
RO,GOVERNADOR JORGE TEIXEIRA,2022,7384,5380,2004,0.271397616
RO,GUAJARÁ-MIRIM,2022,28308,21083,7225,0.255228204
RO,ITAPUÃ DO OESTE,2022,6442,4561,1881,0.291990065
RO,JARU,2022,43093,30073,13020,0.302137238
RO,JI-PARANÁ,2022,92645,69829,22816,0.246273409
RO,MACHADINHO D'OESTE,2022,23659,16549,7110,0.300519887
RO,MINISTRO ANDREAZZA,2022,5996,4629,1367,0.227985324
RO,MIRANTE DA SERRA,2022,9142,6531,2611,0.2856049
RO,MONTE NEGRO,2022,10069,7290,2779,0.27599563
RO,NOVA BRASILÂNDIA D'OESTE,2022,14087,10520,3567,0.253212181
RO,NOVA MAMORÉ,2022,17984,13382,4602,0.255894128
RO,NOVA UNIÃO,2022,5571,4137,1434,0.257404416
RO,NOVO HORIZONTE DO OESTE,2022,6838,5437,1401,0.204884469
RO,OURO PRETO DO OESTE,2022,30386,20985,9401,0.309385901
RO,PARECIS,2022,3261,2482,779,0.238883778
RO,PIMENTA BUENO,2022,26482,20393,6089,0.229929764
RO,PIMENTEIRAS DO OESTE,2022,1988,1509,479,0.240945674
RO,PORTO VELHO,2022,350576,276794,73782,0.210459358
RO,PRESIDENTE MÉDICI,2022,15609,11532,4077,0.261195464
RO,PRIMAVERA DE RONDÔNIA,2022,2872,2260,612,0.213091922
RO,RIO CRESPO,2022,3320,2387,933,0.281024096
RO,ROLIM DE MOURA,2022,40573,29957,10616,0.261651837
RO,SANTA LUZIA D'OESTE,2022,6834,4918,1916,0.280362891
RO,SERINGUEIRAS,2022,10062,7398,2664,0.264758497
RO,SÃO FELIPE D'OESTE,2022,4431,3416,1015,0.22906793
RO,SÃO FRANCISCO DO GUAPORÉ,2022,12555,9377,3178,0.253126245
RO,SÃO MIGUEL DO GUAPORÉ,2022,17415,12954,4461,0.256158484
RO,TEIXEIRÓPOLIS,2022,4091,3049,1042,0.254705451
RO,THEOBROMA,2022,8022,5799,2223,0.277112939
RO,URUPÁ,2022,9547,6822,2725,0.285429978
RO,VALE DO ANARI,2022,6390,4747,1643,0.257120501
RO,VALE DO PARAÍSO,2022,6187,4452,1735,0.280426701
RO,VILHENA,2022,65655,50143,15512,0.236265326
RR,ALTO ALEGRE,2022,10932,9311,1621,0.148280278
RR,AMAJARI,2022,6521,5620,901,0.138168992
RR,BOA VISTA,2022,232392,192275,40117,0.172626424
RR,BONFIM,2022,10221,8661,1560,0.152626945
RR,CANTÁ,2022,13377,11314,2063,0.15421993
RR,CARACARAÍ,2022,14175,11703,2472,0.174391534
RR,CAROEBE,2022,6496,5646,850,0.130849754
RR,IRACEMA,2022,5757,4988,769,0.133576516
RR,MUCAJAÍ,2022,12464,10450,2014,0.161585366
RR,NORMANDIA,2022,7661,6692,969,0.126484793
RR,PACARAIMA,2022,8454,6825,1629,0.192689851
RR,RORAINÓPOLIS,2022,20516,16698,3818,0.186098655
RR,SÃO JOÃO DA BALIZA,2022,4948,4274,674,0.136216653
RR,SÃO LUIZ,2022,5993,5066,927,0.154680461
RR,UIRAMUTÃ,2022,6333,5537,796,0.125690826
RS,ACEGUÁ,2022,3839,3045,794,0.206824694
RS,AGUDO,2022,12429,11036,1393,0.112076595
RS,AJURICABA,2022,5905,4998,907,0.153598645
RS,ALECRIM,2022,5484,4699,785,0.143143691
RS,ALEGRETE,2022,58455,42807,15648,0.267693097
RS,ALEGRIA,2022,3299,2777,522,0.158229767
RS,ALMIRANTE TAMANDARÉ DO SUL,2022,1894,1669,225,0.118796199
RS,ALPESTRE,2022,6229,5044,1185,0.190239204
RS,ALTO ALEGRE,2022,1770,1529,241,0.136158192
RS,ALTO FELIZ,2022,2751,2331,420,0.152671756
RS,ALVORADA,2022,138019,108874,29145,0.211166579
RS,AMARAL FERRADOR,2022,4631,3786,845,0.18246599
RS,AMETISTA DO SUL,2022,5772,4998,774,0.134095634
RS,ANDRÉ DA ROCHA,2022,1331,1119,212,0.159278738
RS,ANTA GORDA,2022,4791,4119,672,0.140262993
RS,ANTÔNIO PRADO,2022,10560,9153,1407,0.133238636
RS,ARAMBARÉ,2022,3517,2709,808,0.229741257
RS,ARARICÁ,2022,5753,4752,1001,0.173996176
RS,ARATIBA,2022,6287,5384,903,0.143629712
RS,ARROIO DO MEIO,2022,16626,14580,2046,0.123060267
RS,ARROIO DO PADRE,2022,2698,2385,313,0.116011861
RS,ARROIO DO SAL,2022,7860,6218,1642,0.208905852
RS,ARROIO DO TIGRE,2022,10364,8599,1765,0.170301042
RS,ARROIO DOS RATOS,2022,10289,8179,2110,0.205073379
RS,ARROIO GRANDE,2022,14773,11971,2802,0.189670345
RS,ARVOREZINHA,2022,8666,7262,1404,0.162012462
RS,AUGUSTO PESTANA,2022,5782,5046,736,0.127291595
RS,BAGÉ,2022,91389,69482,21907,0.239711563
RS,BALNEÁRIO PINHAL,2022,9859,7178,2681,0.271934273
RS,BARRA DO GUARITA,2022,2553,2088,465,0.18213866
RS,BARRA DO QUARAÍ,2022,3081,2351,730,0.23693606
RS,BARRA DO RIBEIRO,2022,10335,8113,2222,0.214997581
RS,BARRA DO RIO AZUL,2022,1737,1517,220,0.126655153
RS,BARRA FUNDA,2022,2680,2310,370,0.138059701
RS,BARRACÃO,2022,4368,3517,851,0.194826007
RS,BARROS CASSAL,2022,8429,6804,1625,0.192786807
RS,BARÃO,2022,4952,4415,537,0.108441034
RS,BARÃO DE COTEGIPE,2022,5402,4669,733,0.135690485
RS,BARÃO DO TRIUNFO,2022,4474,3807,667,0.149083594
RS,BENJAMIN CONSTANT DO SUL,2022,2080,1688,392,0.188461538
RS,BENTO GONÇALVES,2022,91684,75533,16151,0.176159417
RS,BOA VISTA DAS MISSÕES,2022,1952,1593,359,0.183913934
RS,BOA VISTA DO BURICÁ,2022,5537,4844,693,0.125158028
RS,BOA VISTA DO CADEADO,2022,2099,1746,353,0.168175322
RS,BOA VISTA DO INCRA,2022,2139,1870,269,0.125759701
RS,BOA VISTA DO SUL,2022,2496,2095,401,0.160657051
RS,BOM JESUS,2022,8363,6592,1771,0.211766113
RS,BOM PRINCÍPIO,2022,10275,8906,1369,0.13323601
RS,BOM PROGRESSO,2022,2339,1907,432,0.184694314
RS,BOM RETIRO DO SUL,2022,9790,8286,1504,0.153626149
RS,BOQUEIRÃO DO LEÃO,2022,5444,4621,823,0.151175606
RS,BOSSOROCA,2022,5119,4092,1027,0.200625122
RS,BOZANO,2022,2368,2054,314,0.132601351
RS,BRAGA,2022,2849,2338,511,0.179361179
RS,BROCHIER,2022,3878,3383,495,0.127643115
RS,BUTIÁ,2022,14864,11918,2946,0.198196986
RS,CACEQUI,2022,8575,6733,1842,0.214810496
RS,CACHOEIRA DO SUL,2022,66949,49599,17350,0.259152489
RS,CACHOEIRINHA,2022,104314,82060,22254,0.213336657
RS,CACIQUE DOBLE,2022,3986,3390,596,0.149523332
RS,CAIBATÉ,2022,4010,3370,640,0.159600998
RS,CAIÇARA,2022,4272,3635,637,0.149110487
RS,CAMAQUÃ,2022,50698,39939,10759,0.212217444
RS,CAMARGO,2022,2500,2124,376,0.1504
RS,CAMBARÁ DO SUL,2022,4937,4070,867,0.17561272
RS,CAMPESTRE DA SERRA,2022,2712,2249,463,0.170722714
RS,CAMPINA DAS MISSÕES,2022,5143,4411,732,0.14232938
RS,CAMPINAS DO SUL,2022,4602,3961,641,0.139287266
RS,CAMPO BOM,2022,52843,43045,9798,0.185417179
RS,CAMPO NOVO,2022,4099,3276,823,0.200780678
RS,CAMPOS BORGES,2022,3166,2573,593,0.18730259
RS,CANDELÁRIA,2022,22443,18816,3627,0.161609411
RS,CANDIOTA,2022,7914,6454,1460,0.184483194
RS,CANELA,2022,34374,26613,7761,0.225781114
RS,CANGUÇU,2022,44305,35094,9211,0.207899786
RS,CANOAS,2022,258232,206343,51889,0.200939465
RS,CANUDOS DO VALE,2022,1821,1628,193,0.105985722
RS,CAPELA DE SANTANA,2022,7763,6596,1167,0.150328481
RS,CAPITÃO,2022,2758,2362,396,0.143582306
RS,CAPIVARI DO SUL,2022,3709,3025,684,0.184416285
RS,CAPÃO BONITO DO SUL,2022,2038,1713,325,0.159470069
RS,CAPÃO DA CANOA,2022,42362,32607,9755,0.230277135
RS,CAPÃO DO CIPÓ,2022,2893,2334,559,0.193225026
RS,CAPÃO DO LEÃO,2022,17897,14787,3110,0.173772141
RS,CARAZINHO,2022,47226,37854,9372,0.198450006
RS,CARAÁ,2022,6413,5009,1404,0.218930298
RS,CARLOS BARBOSA,2022,22780,19972,2808,0.123266023
RS,CARLOS GOMES,2022,1377,1192,185,0.134350036
RS,CASCA,2022,7633,6405,1228,0.160880388
RS,CASEIROS,2022,3094,2562,532,0.171945701
RS,CATUÍPE,2022,7513,6464,1049,0.139624651
RS,CAXIAS DO SUL,2022,343453,281708,61745,0.179777146
RS,CAÇAPAVA DO SUL,2022,25232,20155,5077,0.201212746
RS,CENTENÁRIO,2022,2603,2316,287,0.110257395
RS,CERRITO,2022,5478,4394,1084,0.197882439
RS,CERRO BRANCO,2022,3656,2977,679,0.185722101
RS,CERRO GRANDE,2022,2579,2116,463,0.179526948
RS,CERRO GRANDE DO SUL,2022,6929,5776,1153,0.166402078
RS,CERRO LARGO,2022,10067,8543,1524,0.151385716
RS,CHAPADA,2022,7773,6763,1010,0.129936961
RS,CHARQUEADAS,2022,25362,20408,4954,0.195331598
RS,CHARRUA,2022,2458,2049,409,0.166395443
RS,CHIAPETTA,2022,3502,2914,588,0.167904055
RS,CHUVISCA,2022,4235,3691,544,0.128453365
RS,CHUÍ,2022,4569,3345,1224,0.267892318
RS,CIDREIRA,2022,11268,8234,3034,0.269258076
RS,CIRÍACO,2022,3692,3185,507,0.137323944
RS,COLINAS,2022,2274,1966,308,0.135444151
RS,COLORADO,2022,3034,2547,487,0.160514173
RS,CONDOR,2022,5902,4759,1143,0.193663165
RS,CONSTANTINA,2022,8257,6765,1492,0.180695168
RS,COQUEIRO BAIXO,2022,1383,1160,223,0.161243673
RS,COQUEIROS DO SUL,2022,2336,1999,337,0.144263699
RS,CORONEL BARROS,2022,2556,2225,331,0.129499218
RS,CORONEL BICACO,2022,6031,4858,1173,0.194495109
RS,CORONEL PILAR,2022,1512,1269,243,0.160714286
RS,COTIPORÃ,2022,3508,3002,506,0.144241733
RS,COXILHA,2022,2666,2291,375,0.140660165
RS,CRISSIUMAL,2022,10756,8743,2013,0.187151357
RS,CRISTAL,2022,6353,5126,1227,0.193137101
RS,CRISTAL DO SUL,2022,2502,2133,369,0.147482014
RS,CRUZ ALTA,2022,47645,36937,10708,0.224745514
RS,CRUZALTENSE,2022,1988,1724,264,0.132796781
RS,CRUZEIRO DO SUL,2022,9478,8196,1282,0.135260604
RS,CÂNDIDO GODÓI,2022,5537,4979,558,0.100776594
RS,DAVID CANABARRO,2022,3993,3434,559,0.139994991
RS,DERRUBADAS,2022,2751,2247,504,0.183206107
RS,DEZESSEIS DE NOVEMBRO,2022,2566,2080,486,0.189399844
RS,DILERMANDO DE AGUIAR,2022,3071,2456,615,0.200260501
RS,DOIS IRMÃOS,2022,24739,20864,3875,0.156635272
RS,DOIS IRMÃOS DAS MISSÕES,2022,1929,1634,295,0.152928979
RS,DOIS LAJEADOS,2022,2997,2544,453,0.151151151
RS,DOM FELICIANO,2022,10434,8573,1861,0.17835921
RS,DOM PEDRITO,2022,29811,22159,7652,0.256683774
RS,DOM PEDRO DE ALCÂNTARA,2022,2449,2118,331,0.135157207
RS,DONA FRANCISCA,2022,3021,2525,496,0.164184045
RS,DOUTOR MAURÍCIO CARDOSO,2022,3941,3376,565,0.143364628
RS,DOUTOR RICARDO,2022,2096,1717,379,0.180820611
RS,ELDORADO DO SUL,2022,26046,21432,4614,0.177148123
RS,ENCANTADO,2022,17674,14200,3474,0.196559919
RS,ENCRUZILHADA DO SUL,2022,18851,15195,3656,0.193941966
RS,ENGENHO VELHO,2022,1213,990,223,0.183841715
RS,ENTRE RIOS DO SUL,2022,2661,2119,542,0.203682826
RS,ENTRE-IJUÍS,2022,7279,6016,1263,0.173512845
RS,EREBANGO,2022,2537,2092,445,0.17540402
RS,ERECHIM,2022,80420,66105,14315,0.178002984
RS,ERNESTINA,2022,2830,2404,426,0.150530035
RS,ERVAL GRANDE,2022,4224,3561,663,0.156960227
RS,ERVAL SECO,2022,5530,4638,892,0.161301989
RS,ESMERALDA,2022,2709,2128,581,0.214470284
RS,ESPERANÇA DO SUL,2022,3015,2562,453,0.150248756
RS,ESPUMOSO,2022,12614,10562,2052,0.162676391
RS,ESTAÇÃO,2022,4857,4162,695,0.143092444
RS,ESTEIO,2022,68376,53608,14768,0.215982216
RS,ESTRELA,2022,25890,21098,4792,0.185090769
RS,ESTRELA VELHA,2022,2936,2493,443,0.150885559
RS,ESTÂNCIA VELHA,2022,37078,30346,6732,0.181563191
RS,EUGÊNIO DE CASTRO,2022,2464,2026,438,0.17775974
RS,FAGUNDES VARELA,2022,2351,2070,281,0.119523607
RS,FARROUPILHA,2022,57293,47468,9825,0.171486918
RS,FAXINAL DO SOTURNO,2022,5775,4778,997,0.172640693
RS,FAXINALZINHO,2022,2335,1922,413,0.176873662
RS,FAZENDA VILANOVA,2022,3457,2905,552,0.15967602
RS,FELIZ,2022,10814,9247,1567,0.144904753
RS,FLORES DA CUNHA,2022,24605,20956,3649,0.14830319
RS,FLORIANO PEIXOTO,2022,1881,1544,337,0.179160021
RS,FONTOURA XAVIER,2022,8362,6633,1729,0.206768716
RS,FORMIGUEIRO,2022,5670,4603,1067,0.188183422
RS,FORQUETINHA,2022,2384,2096,288,0.120805369
RS,FORTALEZA DOS VALOS,2022,3714,3257,457,0.123047927
RS,FREDERICO WESTPHALEN,2022,25616,20686,4930,0.192457839
RS,GARIBALDI,2022,25815,22299,3516,0.136199884
RS,GARRUCHOS,2022,2579,2044,535,0.207444746
RS,GAURAMA,2022,5178,4447,731,0.141174199
RS,GENERAL CÂMARA,2022,6215,5061,1154,0.185679807
RS,GENTIL,2022,1629,1372,257,0.1577655
RS,GETÚLIO VARGAS,2022,13216,10536,2680,0.202784504
RS,GIRUÁ,2022,12809,10629,2180,0.170192833
RS,GLORINHA,2022,6532,5215,1317,0.20162278
RS,GRAMADO,2022,33455,26394,7061,0.211059632
RS,GRAMADO DOS LOUREIROS,2022,2216,1850,366,0.165162455
RS,GRAMADO XAVIER,2022,3015,2491,524,0.173797678
RS,GRAVATAÍ,2022,191626,152041,39585,0.206574264
RS,GUABIJU,2022,1407,1188,219,0.15565032
RS,GUAPORÉ,2022,18695,16000,2695,0.144156191
RS,GUARANI DAS MISSÕES,2022,5916,5115,801,0.135395538
RS,GUAÍBA,2022,75682,59811,15871,0.209706403
RS,HARMONIA,2022,3913,3494,419,0.107078968
RS,HERVAL,2022,5234,4023,1211,0.2313718
RS,HERVEIRAS,2022,2548,2139,409,0.160518053
RS,HORIZONTINA,2022,14681,12428,2253,0.153463661
RS,HULHA NEGRA,2022,4775,3912,863,0.180732984
RS,HUMAITÁ,2022,4099,3486,613,0.14954867
RS,IBARAMA,2022,3578,3049,529,0.14784796
RS,IBIAÇÁ,2022,3932,3410,522,0.132756867
RS,IBIRAIARAS,2022,5399,4645,754,0.139655492
RS,IBIRAPUITÃ,2022,3516,2920,596,0.169510808
RS,IBIRUBÁ,2022,16258,13873,2385,0.146697011
RS,IGREJINHA,2022,27529,22809,4720,0.171455556
RS,IJUÍ,2022,65021,52862,12159,0.187001123
RS,ILÓPOLIS,2022,3586,2994,592,0.165086447
RS,IMBÉ,2022,20805,15374,5431,0.261043019
RS,IMIGRANTE,2022,2689,2205,484,0.179992562
RS,INDEPENDÊNCIA,2022,5488,4662,826,0.150510204
RS,INHACORÁ,2022,1985,1615,370,0.186397985
RS,IPIRANGA DO SUL,2022,1969,1695,274,0.139156932
RS,IPÊ,2022,5478,4620,858,0.156626506
RS,IRAÍ,2022,6498,4858,1640,0.252385349
RS,ITAARA,2022,4271,3558,713,0.166939827
RS,ITACURUBI,2022,2683,2148,535,0.199403653
RS,ITAPUCA,2022,1785,1496,289,0.161904762
RS,ITAQUI,2022,27995,19999,7996,0.285622433
RS,ITATI,2022,3284,2694,590,0.179658952
RS,ITATIBA DO SUL,2022,3491,2977,514,0.147235749
RS,IVORÁ,2022,1870,1524,346,0.185026738
RS,IVOTI,2022,16309,14566,1743,0.106873505
RS,JABOTICABA,2022,3243,2677,566,0.174529756
RS,JACUIZINHO,2022,1968,1691,277,0.140752033
RS,JACUTINGA,2022,2930,2497,433,0.14778157
RS,JAGUARI,2022,8663,7296,1367,0.15779753
RS,JAGUARÃO,2022,20902,16038,4864,0.232705004
RS,JAQUIRANA,2022,3497,2745,752,0.215041464
RS,JARI,2022,2826,2367,459,0.162420382
RS,JÓIA,2022,6162,5289,873,0.141674781
RS,JÚLIO DE CASTILHOS,2022,15114,12341,2773,0.183472277
RS,LAGOA BONITA DO SUL,2022,2337,1920,417,0.17843389
RS,LAGOA DOS TRÊS CANTOS,2022,1603,1383,220,0.13724267
RS,LAGOA VERMELHA,2022,20195,16649,3546,0.175588017
RS,LAGOÃO,2022,4597,3809,788,0.171416141
RS,LAJEADO,2022,63378,51941,11437,0.180456941
RS,LAJEADO DO BUGRE,2022,2002,1615,387,0.193306693
RS,LAVRAS DO SUL,2022,5480,4512,968,0.176642336
RS,LIBERATO SALZANO,2022,4418,3589,829,0.187641467
RS,LINDOLFO COLLOR,2022,4569,3952,617,0.13504049
RS,LINHA NOVA,2022,1448,1209,239,0.165055249
RS,MACHADINHO,2022,4680,3994,686,0.146581197
RS,MAMPITUBA,2022,2859,2428,431,0.150752011
RS,MANOEL VIANA,2022,5500,4389,1111,0.202
RS,MAQUINÉ,2022,5831,4923,908,0.155719431
RS,MARATÁ,2022,2323,2020,303,0.130434783
RS,MARAU,2022,31963,26593,5370,0.168006758
RS,MARCELINO RAMOS,2022,3846,3247,599,0.15574623
RS,MARIANA PIMENTEL,2022,3549,2915,634,0.178641871
RS,MARIANO MORO,2022,2158,1814,344,0.159406858
RS,MARQUES DE SOUZA,2022,3484,2917,567,0.162743972
RS,MATA,2022,4070,3279,791,0.194348894
RS,MATO CASTELHANO,2022,2746,2327,419,0.152585579
RS,MATO LEITÃO,2022,3929,3363,566,0.144057012
RS,MATO QUEIMADO,2022,1617,1347,270,0.166975881
RS,MAXIMILIANO DE ALMEIDA,2022,4014,3317,697,0.173642252
RS,MAÇAMBARÁ,2022,3959,3056,903,0.228087901
RS,MINAS DO LEÃO,2022,6272,5124,1148,0.183035714
RS,MIRAGUAÍ,2022,4199,3564,635,0.151226482
RS,MONTAURI,2022,1474,1238,236,0.160108548
RS,MONTE ALEGRE DOS CAMPOS,2022,3262,2490,772,0.236664623
RS,MONTE BELO DO SUL,2022,3012,2607,405,0.134462151
RS,MONTENEGRO,2022,48461,38080,10381,0.214213491
RS,MORMAÇO,2022,2701,2263,438,0.162162162
RS,MORRINHOS DO SUL,2022,3072,2658,414,0.134765625
RS,MORRO REDONDO,2022,5291,4342,949,0.179361179
RS,MORRO REUTER,2022,5356,4666,690,0.128827483
RS,MOSTARDAS,2022,8938,7100,1838,0.205638845
RS,MUITOS CAPÕES,2022,2723,2189,534,0.196107235
RS,MULITERNO,2022,2107,1743,364,0.172757475
RS,MUÇUM,2022,4123,3512,611,0.148193063
RS,NICOLAU VERGUEIRO,2022,2200,1792,408,0.185454545
RS,NONOAI,2022,9480,7660,1820,0.191983122
RS,NOVA ALVORADA,2022,2745,2405,340,0.123861566
RS,NOVA ARAÇÁ,2022,3999,3317,682,0.170542636
RS,NOVA BASSANO,2022,7109,6211,898,0.126318751
RS,NOVA BOA VISTA,2022,1995,1767,228,0.114285714
RS,NOVA BRÉSCIA,2022,2728,2341,387,0.14186217
RS,NOVA CANDELÁRIA,2022,2536,2307,229,0.090299685
RS,NOVA ESPERANÇA DO SUL,2022,4252,3582,670,0.157572907
RS,NOVA HARTZ,2022,14457,12376,2081,0.14394411
RS,NOVA PALMA,2022,5181,4384,797,0.153831307
RS,NOVA PETRÓPOLIS,2022,17105,14538,2567,0.150073078
RS,NOVA PRATA,2022,18469,15946,2523,0.136607288
RS,NOVA PÁDUA,2022,2401,2047,354,0.147438567
RS,NOVA RAMADA,2022,2030,1741,289,0.142364532
RS,NOVA ROMA DO SUL,2022,3063,2683,380,0.124061378
RS,NOVA SANTA RITA,2022,18887,15243,3644,0.192936941
RS,NOVO BARREIRO,2022,3618,3162,456,0.126036484
RS,NOVO CABRAIS,2022,3666,3093,573,0.156301146
RS,NOVO HAMBURGO,2022,180479,144280,36199,0.200571812
RS,NOVO MACHADO,2022,3148,2683,465,0.147712834
RS,NOVO TIRADENTES,2022,1849,1550,299,0.161709032
RS,NOVO XINGU,2022,1592,1337,255,0.160175879
RS,NÃO-ME-TOQUE,2022,13147,11195,1952,0.148474937
RS,OSÓRIO,2022,37291,29398,7893,0.21165965
RS,PAIM FILHO,2022,3851,3250,601,0.15606336
RS,PALMARES DO SUL,2022,10893,8193,2700,0.247865602
RS,PALMEIRA DAS MISSÕES,2022,24079,19935,4144,0.17210017
RS,PALMITINHO,2022,5922,5105,817,0.137960149
RS,PANAMBI,2022,31871,26570,5301,0.166326755
RS,PANTANO GRANDE,2022,8252,6686,1566,0.189772176
RS,PARAÍ,2022,6130,5219,911,0.148613377
RS,PARAÍSO DO SUL,2022,5331,4596,735,0.137872819
RS,PARECI NOVO,2022,3308,2871,437,0.13210399
RS,PAROBÉ,2022,39540,32641,6899,0.174481538
RS,PASSA SETE,2022,3767,3170,597,0.15848155
RS,PASSO DO SOBRADO,2022,4968,4369,599,0.120571659
RS,PASSO FUNDO,2022,149799,120648,29151,0.194600765
RS,PAULO BENTO,2022,2053,1833,220,0.107160253
RS,PAVERAMA,2022,5847,4888,959,0.164015735
RS,PEDRAS ALTAS,2022,2009,1572,437,0.217521155
RS,PEDRO OSÓRIO,2022,6990,5446,1544,0.220886981
RS,PEJUÇARA,2022,3102,2631,471,0.151837524
RS,PELOTAS,2022,247744,201978,45766,0.184731013
RS,PICADA CAFÉ,2022,4466,3815,651,0.145768025
RS,PINHAL,2022,2315,1994,321,0.138660907
RS,PINHAL DA SERRA,2022,2486,1921,565,0.227272727
RS,PINHAL GRANDE,2022,3598,2938,660,0.183435242
RS,PINHEIRINHO DO VALE,2022,3670,3146,524,0.142779292
RS,PINHEIRO MACHADO,2022,10157,7688,2469,0.243083588
RS,PINTO BANDEIRA,2022,2406,2040,366,0.152119701
RS,PIRAPÓ,2022,2299,1725,574,0.249673771
RS,PIRATINI,2022,14809,11915,2894,0.195421703
RS,PLANALTO,2022,8035,6461,1574,0.195892968
RS,PONTE PRETA,2022,1785,1580,205,0.114845938
RS,PONTÃO,2022,3338,2842,496,0.148591971
RS,PORTO ALEGRE,2022,1103600,855346,248254,0.224949257
RS,PORTO LUCENA,2022,3936,3241,695,0.176575203
RS,PORTO MAUÁ,2022,2253,1884,369,0.163781625
RS,PORTO VERA CRUZ,2022,1696,1414,282,0.166273585
RS,PORTO XAVIER,2022,7738,6538,1200,0.155078832
RS,PORTÃO,2022,25431,20905,4526,0.177971767
RS,POUSO NOVO,2022,1632,1404,228,0.139705882
RS,POÇO DAS ANTAS,2022,2001,1702,299,0.149425287
RS,PRESIDENTE LUCENA,2022,2520,2273,247,0.098015873
RS,PROGRESSO,2022,4939,4332,607,0.122899372
RS,PROTÁSIO ALVES,2022,1881,1644,237,0.12599681
RS,PUTINGA,2022,3887,3020,867,0.223051196
RS,QUARAÍ,2022,17725,13713,4012,0.226346968
RS,QUATRO IRMÃOS,2022,1636,1410,226,0.138141809
RS,QUEVEDOS,2022,2343,1911,432,0.184379001
RS,QUINZE DE NOVEMBRO,2022,3616,3093,523,0.144634956
RS,REDENTORA,2022,6754,5176,1578,0.233639325
RS,RELVADO,2022,2057,1660,397,0.192999514
RS,RESTINGA SÊCA,2022,12434,10310,2124,0.17082194
RS,RIO DOS ÍNDIOS,2022,2912,2355,557,0.191277473
RS,RIO GRANDE,2022,155633,117816,37817,0.242988312
RS,RIO PARDO,2022,29838,23202,6636,0.222400965
RS,RIOZINHO,2022,4018,3430,588,0.146341463
RS,ROCA SALES,2022,7740,6751,989,0.127777778
RS,RODEIO BONITO,2022,5103,4360,743,0.145600627
RS,ROLADOR,2022,2350,1961,389,0.165531915
RS,ROLANTE,2022,16233,13913,2320,0.142918746
RS,RONDA ALTA,2022,7325,6284,1041,0.142116041
RS,RONDINHA,2022,4624,3968,656,0.141868512
RS,ROQUE GONZALES,2022,5397,4650,747,0.138410228
RS,ROSÁRIO DO SUL,2022,32189,23793,8396,0.260834447
RS,SAGRADA FAMÍLIA,2022,2253,1865,388,0.172214825
RS,SALDANHA MARINHO,2022,2666,2333,333,0.124906227
RS,SALTO DO JACUÍ,2022,8018,6484,1534,0.191319531
RS,SALVADOR DAS MISSÕES,2022,2621,2308,313,0.119420069
RS,SALVADOR DO SUL,2022,5479,4811,668,0.121920058
RS,SANANDUVA,2022,13273,11178,2095,0.157839222
RS,SANT'ANA DO LIVRAMENTO,2022,73905,52353,21552,0.291617617
RS,SANTA BÁRBARA DO SUL,2022,6962,5737,1225,0.175955185
RS,SANTA CECÍLIA DO SUL,2022,1822,1570,252,0.13830955
RS,SANTA CLARA DO SUL,2022,5346,4631,715,0.133744856
RS,SANTA CRUZ DO SUL,2022,105317,86240,19077,0.181138847
RS,SANTA MARGARIDA DO SUL,2022,2634,2172,462,0.175398633
RS,SANTA MARIA,2022,208727,164861,43866,0.210159682
RS,SANTA MARIA DO HERVAL,2022,5171,4699,472,0.091278283
RS,SANTA ROSA,2022,57869,47667,10202,0.176294735
RS,SANTA TEREZA,2022,1725,1505,220,0.127536232
RS,SANTA VITÓRIA DO PALMAR,2022,24655,17922,6733,0.273088623
RS,SANTANA DA BOA VISTA,2022,6454,5098,1356,0.210102262
RS,SANTIAGO,2022,41107,31202,9905,0.240956528
RS,SANTO ANTÔNIO DA PATRULHA,2022,34058,26764,7294,0.214164073
RS,SANTO ANTÔNIO DAS MISSÕES,2022,8674,6852,1822,0.210053032
RS,SANTO ANTÔNIO DO PALMA,2022,1925,1662,263,0.136623377
RS,SANTO ANTÔNIO DO PLANALTO,2022,2039,1784,255,0.125061305
RS,SANTO AUGUSTO,2022,11248,9221,2027,0.180209815
RS,SANTO CRISTO,2022,12960,11078,1882,0.145216049
RS,SANTO EXPEDITO DO SUL,2022,2212,1895,317,0.143309222
RS,SANTO ÂNGELO,2022,61206,47303,13903,0.227150933
RS,SAPIRANGA,2022,62252,51240,11012,0.176893915
RS,SAPUCAIA DO SUL,2022,105557,81964,23593,0.223509573
RS,SARANDI,2022,16768,14273,2495,0.148795324
RS,SEBERI,2022,9027,7697,1330,0.14733577
RS,SEDE NOVA,2022,2413,2108,305,0.126398674
RS,SEGREDO,2022,5559,4645,914,0.164418061
RS,SELBACH,2022,4394,3742,652,0.14838416
RS,SENADOR SALGADO FILHO,2022,2620,2291,329,0.125572519
RS,SENTINELA DO SUL,2022,4202,3403,799,0.190147549
RS,SERAFINA CORRÊA,2022,12544,10678,1866,0.148756378
RS,SERTÃO,2022,4910,4254,656,0.133604888
RS,SERTÃO SANTANA,2022,5337,4349,988,0.185122728
RS,SETE DE SETEMBRO,2022,1798,1540,258,0.14349277
RS,SEVERIANO DE ALMEIDA,2022,3447,2917,530,0.15375689
RS,SILVEIRA MARTINS,2022,2232,1841,391,0.175179211
RS,SINIMBU,2022,6806,6051,755,0.110931531
RS,SOBRADINHO,2022,11433,9094,2339,0.204583224
RS,SOLEDADE,2022,21564,18068,3496,0.162122055
RS,SÃO BORJA,2022,48635,36424,12211,0.251074329
RS,SÃO DOMINGOS DO SUL,2022,2628,2241,387,0.147260274
RS,SÃO FRANCISCO DE ASSIS,2022,14542,11840,2702,0.185806629
RS,SÃO FRANCISCO DE PAULA,2022,15648,12811,2837,0.181301125
RS,SÃO GABRIEL,2022,45795,34294,11501,0.251140954
RS,SÃO JERÔNIMO,2022,15457,12748,2709,0.1752604
RS,SÃO JORGE,2022,2457,2156,301,0.122507123
RS,SÃO JOSÉ DAS MISSÕES,2022,2197,1853,344,0.156577151
RS,SÃO JOSÉ DO HERVAL,2022,2073,1590,483,0.232995658
RS,SÃO JOSÉ DO HORTÊNCIO,2022,3527,3171,356,0.100935639
RS,SÃO JOSÉ DO INHACORÁ,2022,2224,1956,268,0.120503597
RS,SÃO JOSÉ DO NORTE,2022,20418,16778,3640,0.178274072
RS,SÃO JOSÉ DO OURO,2022,5778,4969,809,0.140013846
RS,SÃO JOSÉ DO SUL,2022,1952,1741,211,0.108094262
RS,SÃO JOSÉ DOS AUSENTES,2022,3124,2426,698,0.223431498
RS,SÃO JOÃO DA URTIGA,2022,4133,3598,535,0.129445923
RS,SÃO JOÃO DO POLÊSINE,2022,2572,2103,469,0.182348367
RS,SÃO LEOPOLDO,2022,167713,131788,35925,0.21420522
RS,SÃO LOURENÇO DO SUL,2022,35961,28385,7576,0.210672673
RS,SÃO LUIZ GONZAGA,2022,27018,20407,6611,0.244688726
RS,SÃO MARCOS,2022,16155,14061,2094,0.129619313
RS,SÃO MARTINHO,2022,4870,4203,667,0.136960986
RS,SÃO MARTINHO DA SERRA,2022,3086,2464,622,0.201555412
RS,SÃO MIGUEL DAS MISSÕES,2022,5829,4837,992,0.170183565
RS,SÃO NICOLAU,2022,4098,3360,738,0.180087848
RS,SÃO PAULO DAS MISSÕES,2022,5230,4414,816,0.156022945
RS,SÃO PEDRO DA SERRA,2022,3131,2774,357,0.11402108
RS,SÃO PEDRO DAS MISSÕES,2022,1589,1322,267,0.168030208
RS,SÃO PEDRO DO BUTIÁ,2022,2544,2224,320,0.125786164
RS,SÃO PEDRO DO SUL,2022,12779,10512,2267,0.177400423
RS,SÃO SEBASTIÃO DO CAÍ,2022,17151,14484,2667,0.155501137
RS,SÃO SEPÉ,2022,17079,13972,3107,0.181919316
RS,SÃO VALENTIM,2022,3097,2617,480,0.154988699
RS,SÃO VALENTIM DO SUL,2022,2213,1857,356,0.160867601
RS,SÃO VALÉRIO DO SUL,2022,2264,1787,477,0.210689046
RS,SÃO VENDELINO,2022,2283,2011,272,0.119141481
RS,SÃO VICENTE DO SUL,2022,7232,5559,1673,0.231332965
RS,SÉRIO,2022,2007,1726,281,0.140009965
RS,TABAÍ,2022,3863,3262,601,0.155578566
RS,TAPEJARA,2022,17087,14545,2542,0.148768069
RS,TAPERA,2022,7991,6793,1198,0.149918658
RS,TAPES,2022,11456,9194,2262,0.197451117
RS,TAQUARA,2022,41995,33468,8527,0.203047982
RS,TAQUARI,2022,19491,16334,3157,0.161972192
RS,TAQUARUÇU DO SUL,2022,2729,2388,341,0.124954196
RS,TAVARES,2022,4546,3609,937,0.206115266
RS,TENENTE PORTELA,2022,10430,8627,1803,0.172866731
RS,TERRA DE AREIA,2022,7609,6184,1425,0.187278223
RS,TEUTÔNIA,2022,25045,21227,3818,0.152445598
RS,TIO HUGO,2022,2531,2199,332,0.131173449
RS,TIRADENTES DO SUL,2022,4589,3711,878,0.191327087
RS,TOROPI,2022,2677,2286,391,0.146059021
RS,TORRES,2022,31518,24334,7184,0.227933244
RS,TRAMANDAÍ,2022,37402,27381,10021,0.267926849
RS,TRAVESSEIRO,2022,1960,1725,235,0.119897959
RS,TRINDADE DO SUL,2022,5129,4316,813,0.158510431
RS,TRIUNFO,2022,21982,17593,4389,0.199663361
RS,TRÊS ARROIOS,2022,2459,2096,363,0.147620984
RS,TRÊS CACHOEIRAS,2022,7873,6831,1042,0.132351073
RS,TRÊS COROAS,2022,17519,14903,2616,0.149323592
RS,TRÊS DE MAIO,2022,17936,15441,2495,0.139105709
RS,TRÊS FORQUILHAS,2022,2875,2392,483,0.168
RS,TRÊS PALMEIRAS,2022,3883,3285,598,0.154004636
RS,TRÊS PASSOS,2022,18465,15694,2771,0.150067696
RS,TUCUNDUVA,2022,4763,4051,712,0.149485618
RS,TUNAS,2022,3353,2786,567,0.169102296
RS,TUPANCI DO SUL,2022,1463,1212,251,0.171565277
RS,TUPANCIRETÃ,2022,16321,13043,3278,0.200845536
RS,TUPANDI,2022,4240,3736,504,0.118867925
RS,TUPARENDI,2022,7120,5948,1172,0.164606742
RS,TURUÇU,2022,3402,2787,615,0.180776014
RS,UBIRETAMA,2022,1868,1654,214,0.114561028
RS,UNISTALDA,2022,2643,2129,514,0.194475974
RS,UNIÃO DA SERRA,2022,1510,1285,225,0.149006623
RS,URUGUAIANA,2022,88062,63395,24667,0.280109468
RS,VACARIA,2022,47324,36844,10480,0.221452117
RS,VALE DO SOL,2022,8242,7079,1163,0.141106528
RS,VALE REAL,2022,4818,4093,725,0.150477377
RS,VALE VERDE,2022,3098,2550,548,0.176888315
RS,VANINI,2022,2030,1735,295,0.145320197
RS,VENÂNCIO AIRES,2022,53567,44615,8952,0.167117815
RS,VERA CRUZ,2022,18558,16675,1883,0.101465675
RS,VERANÓPOLIS,2022,18173,15712,2461,0.135420679
RS,VESPASIANO CORRÊA,2022,2242,1898,344,0.153434434
RS,VIADUTOS,2022,4171,3591,580,0.139055382
RS,VIAMÃO,2022,162815,130439,32376,0.198851457
RS,VICENTE DUTRA,2022,3798,3119,679,0.178778304
RS,VICTOR GRAEFF,2022,2511,2127,384,0.152927121
RS,VILA FLORES,2022,3289,2898,391,0.118881119
RS,VILA LÂNGARO,2022,2137,1870,267,0.124941507
RS,VILA MARIA,2022,3570,3072,498,0.139495798
RS,VILA NOVA DO SUL,2022,3792,2962,830,0.218881857
RS,VISTA ALEGRE,2022,2479,2170,309,0.124647035
RS,VISTA ALEGRE DO PRATA,2022,1600,1367,233,0.145625
RS,VISTA GAÚCHA,2022,2653,2197,456,0.17188089
RS,VITÓRIA DAS MISSÕES,2022,3339,2757,582,0.174303684
RS,WESTFALIA,2022,2605,2284,321,0.123224568
RS,XANGRI-LÁ,2022,12302,9918,2384,0.193789628
RS,ÁGUA SANTA,2022,3099,2703,396,0.127783156
RS,ÁUREA,2022,3108,2806,302,0.097168597
SC,ABDON BATISTA,2022,2506,2137,369,0.147246608
SC,ABELARDO LUZ,2022,12816,9716,3100,0.241885144
SC,AGROLÂNDIA,2022,8007,6795,1212,0.151367553
SC,AGRONÔMICA,2022,4351,3740,611,0.140427488
SC,ALFREDO WAGNER,2022,7661,6724,937,0.122307793
SC,ALTO BELA VISTA,2022,1852,1533,319,0.17224622
SC,ANCHIETA,2022,4966,4215,751,0.151228353
SC,ANGELINA,2022,4995,4408,587,0.117517518
SC,ANITA GARIBALDI,2022,7476,5786,1690,0.226056715
SC,ANITÁPOLIS,2022,3147,2720,427,0.135684779
SC,ANTÔNIO CARLOS,2022,8345,7306,1039,0.124505692
SC,APIÚNA,2022,8202,6694,1508,0.183857596
SC,ARABUTÃ,2022,3841,3206,635,0.165321531
SC,ARAQUARI,2022,23917,18550,5367,0.224401054
SC,ARARANGUÁ,2022,52898,42010,10888,0.205830088
SC,ARMAZÉM,2022,6543,5614,929,0.141983799
SC,ARROIO TRINTA,2022,3177,2675,502,0.158010702
SC,ARVOREDO,2022,2450,2125,325,0.132653061
SC,ASCURRA,2022,6354,5155,1199,0.188700031
SC,ATALANTA,2022,2900,2515,385,0.132758621
SC,AURORA,2022,5112,4448,664,0.129890454
SC,BALNEÁRIO ARROIO DO SILVA,2022,11564,8682,2882,0.249221723
SC,BALNEÁRIO BARRA DO SUL,2022,10852,8110,2742,0.252672318
SC,BALNEÁRIO CAMBORIÚ,2022,101641,80124,21517,0.211696068
SC,BALNEÁRIO GAIVOTA,2022,10527,8041,2486,0.23615465
SC,BALNEÁRIO PIÇARRAS,2022,18484,14451,4033,0.218188704
SC,BALNEÁRIO RINCÃO,2022,12430,9583,2847,0.229042639
SC,BANDEIRANTE,2022,2892,2384,508,0.175656985
SC,BARRA BONITA,2022,1844,1483,361,0.195770065
SC,BARRA VELHA,2022,26993,19830,7163,0.265365095
SC,BELA VISTA DO TOLDO,2022,5118,4259,859,0.167839
SC,BELMONTE,2022,2404,1985,419,0.174292845
SC,BENEDITO NOVO,2022,8245,6814,1431,0.173559733
SC,BIGUAÇU,2022,53041,43129,9912,0.186874305
SC,BLUMENAU,2022,261742,216043,45699,0.174595594
SC,BOCAINA DO SUL,2022,3128,2635,493,0.157608696
SC,BOM JARDIM DA SERRA,2022,3631,2917,714,0.196640044
SC,BOM JESUS,2022,2504,2075,429,0.171325879
SC,BOM JESUS DO OESTE,2022,1889,1640,249,0.131815776
SC,BOM RETIRO,2022,6513,5372,1141,0.175188085
SC,BOMBINHAS,2022,16923,13552,3371,0.19919636
SC,BOTUVERÁ,2022,4316,3830,486,0.112604263
SC,BRAÇO DO NORTE,2022,24805,20559,4246,0.171175166
SC,BRAÇO DO TROMBUDO,2022,3087,2722,365,0.118237771
SC,BRUNÓPOLIS,2022,2772,2316,456,0.164502165
SC,BRUSQUE,2022,94898,79759,15139,0.159529179
SC,CAIBI,2022,4929,4133,796,0.161493203
SC,CALMON,2022,3204,2440,764,0.238451935
SC,CAMBORIÚ,2022,56981,44834,12147,0.213176322
SC,CAMPO ALEGRE,2022,9801,7988,1813,0.184981124
SC,CAMPO BELO DO SUL,2022,5983,4889,1094,0.182851412
SC,CAMPO ERÊ,2022,7239,5817,1422,0.196435972
SC,CAMPOS NOVOS,2022,26706,20980,5726,0.214408747
SC,CANELINHA,2022,9206,7545,1661,0.180425809
SC,CANOINHAS,2022,42924,33848,9076,0.211443482
SC,CAPINZAL,2022,17209,14154,3055,0.177523389
SC,CAPIVARI DE BAIXO,2022,17746,14496,3250,0.183139863
SC,CAPÃO ALTO,2022,2928,2380,548,0.18715847
SC,CATANDUVAS,2022,8215,6833,1382,0.16822885
SC,CAXAMBU DO SUL,2022,4370,3720,650,0.148741419
SC,CAÇADOR,2022,53740,41745,11995,0.223204317
SC,CELSO RAMOS,2022,2584,2185,399,0.154411765
SC,CERRO NEGRO,2022,3215,2633,582,0.181026439
SC,CHAPADÃO DO LAGEADO,2022,2564,2264,300,0.11700468
SC,CHAPECÓ,2022,159323,130962,28361,0.178009452
SC,COCAL DO SUL,2022,14344,11457,2887,0.201268823
SC,CONCÓRDIA,2022,59654,48827,10827,0.181496631
SC,CORDILHEIRA ALTA,2022,4017,3437,580,0.144386358
SC,CORONEL FREITAS,2022,8163,6911,1252,0.153374985
SC,CORONEL MARTINS,2022,1972,1718,254,0.128803245
SC,CORREIA PINTO,2022,11889,9950,1939,0.163091934
SC,CORUPÁ,2022,11468,9993,1475,0.128618765
SC,CRICIÚMA,2022,152206,121420,30786,0.202265351
SC,CUNHA PORÃ,2022,8548,7556,992,0.116050538
SC,CUNHATAÍ,2022,1762,1554,208,0.118047673
SC,CURITIBANOS,2022,31501,24103,7398,0.234849687
SC,DESCANSO,2022,7026,5943,1083,0.154141759
SC,DIONÍSIO CERQUEIRA,2022,11669,8733,2936,0.251606821
SC,DONA EMMA,2022,3223,2700,523,0.162271176
SC,DOUTOR PEDRINHO,2022,3009,2493,516,0.171485543
SC,ENTRE RIOS,2022,2975,2445,530,0.178151261
SC,ERMO,2022,2210,1972,238,0.107692308
SC,ERVAL VELHO,2022,3964,3286,678,0.171039354
SC,FAXINAL DOS GUEDES,2022,8872,7444,1428,0.160955816
SC,FLOR DO SERTÃO,2022,1731,1445,286,0.165222415
SC,FLORIANÓPOLIS,2022,399606,327747,71859,0.179824627
SC,FORMOSA DO SUL,2022,2406,2018,388,0.161263508
SC,FORQUILHINHA,2022,20798,17504,3294,0.158380614
SC,FRAIBURGO,2022,27947,21547,6400,0.229004902
SC,FREI ROGÉRIO,2022,2275,1846,429,0.188571429
SC,GALVÃO,2022,2713,2314,399,0.147069665
SC,GAROPABA,2022,21287,17472,3815,0.179217363
SC,GARUVA,2022,11754,9685,2069,0.176025183
SC,GASPAR,2022,49386,40016,9370,0.189729883
SC,GOVERNADOR CELSO RAMOS,2022,14682,12318,2364,0.161013486
SC,GRAVATAL,2022,9002,7548,1454,0.161519662
SC,GRÃO-PARÁ,2022,5609,4840,769,0.137101088
SC,GUABIRUBA,2022,16027,14126,1901,0.118612342
SC,GUARACIABA,2022,9049,7628,1421,0.157033926
SC,GUARAMIRIM,2022,32165,26013,6152,0.191263796
SC,GUARUJÁ DO SUL,2022,4013,3265,748,0.186394219
SC,GUATAMBÚ,2022,5847,4988,859,0.146912947
SC,HERVAL D'OESTE,2022,16868,13598,3270,0.193858193
SC,IBIAM,2022,1826,1564,262,0.143483023
SC,IBICARÉ,2022,2986,2477,509,0.170462157
SC,IBIRAMA,2022,15225,11869,3356,0.220426929
SC,ILHOTA,2022,11357,9167,2190,0.192832614
SC,IMARUÍ,2022,9551,7727,1824,0.190974767
SC,IMBITUBA,2022,39487,30257,9230,0.233747816
SC,IMBUIA,2022,4908,4309,599,0.12204564
SC,INDAIAL,2022,48509,38403,10106,0.208332474
SC,IOMERÊ,2022,2771,2354,417,0.150487189
SC,IPIRA,2022,3842,3194,648,0.168662155
SC,IPORÃ DO OESTE,2022,7285,6206,1079,0.14811256
SC,IPUAÇU,2022,5574,4586,988,0.177251525
SC,IPUMIRIM,2022,6061,5081,980,0.16168949
SC,IRACEMINHA,2022,3674,3117,557,0.151605879
SC,IRANI,2022,7522,6304,1218,0.16192502
SC,IRATI,2022,2047,1742,305,0.148998534
SC,IRINEÓPOLIS,2022,8029,6610,1419,0.176734338
SC,ITAIÓPOLIS,2022,17012,13516,3496,0.205501999
SC,ITAJAÍ,2022,163901,135292,28609,0.174550491
SC,ITAPEMA,2022,50477,39565,10912,0.216177665
SC,ITAPIRANGA,2022,12358,10232,2126,0.17203431
SC,ITAPOÁ,2022,17560,13720,3840,0.218678815
SC,ITUPORANGA,2022,19075,16005,3070,0.160943644
SC,ITÁ,2022,6011,4952,1059,0.176177009
SC,IÇARA,2022,42243,34031,8212,0.194399072
SC,JABORÁ,2022,3803,3284,519,0.136471207
SC,JACINTO MACHADO,2022,9107,7492,1615,0.177336115
SC,JAGUARUNA,2022,15206,12258,2948,0.19387084
SC,JARAGUÁ DO SUL,2022,122232,105143,17089,0.139807906
SC,JARDINÓPOLIS,2022,1606,1445,161,0.100249066
SC,JOAÇABA,2022,22613,18332,4281,0.18931588
SC,JOINVILLE,2022,428730,356956,71774,0.167410725
SC,JOSÉ BOITEUX,2022,4295,3511,784,0.182537835
SC,JUPIÁ,2022,2138,1896,242,0.113189897
SC,LACERDÓPOLIS,2022,2028,1720,308,0.151873767
SC,LAGES,2022,125963,99966,25997,0.206386002
SC,LAGUNA,2022,35918,28520,7398,0.205969152
SC,LAJEADO GRANDE,2022,1472,1311,161,0.109375
SC,LAURENTINO,2022,5985,5113,872,0.145697577
SC,LAURO MÜLLER,2022,12290,10205,2085,0.169650122
SC,LEBON RÉGIS,2022,8901,6806,2095,0.235366813
SC,LEOBERTO LEAL,2022,3182,2739,443,0.139220616
SC,LINDÓIA DO SUL,2022,3650,3010,640,0.175342466
SC,LONTRAS,2022,8999,7353,1646,0.182909212
SC,LUIZ ALVES,2022,9930,8477,1453,0.14632427
SC,LUZERNA,2022,5017,4310,707,0.140920869
SC,MACIEIRA,2022,1774,1488,286,0.161217587
SC,MAFRA,2022,41455,34839,6616,0.159594741
SC,MAJOR GERCINO,2022,3109,2518,591,0.190093278
SC,MAJOR VIEIRA,2022,5909,4888,1021,0.172787274
SC,MARACAJÁ,2022,6316,5308,1008,0.15959468
SC,MARAVILHA,2022,20302,16574,3728,0.183627229
SC,MAREMA,2022,2004,1797,207,0.103293413
SC,MASSARANDUBA,2022,13038,11055,1983,0.152093879
SC,MATOS COSTA,2022,2464,1895,569,0.230925325
SC,MELEIRO,2022,6039,5086,953,0.157807584
SC,MIRIM DOCE,2022,2321,1961,360,0.155105558
SC,MODELO,2022,3398,2928,470,0.138316657
SC,MONDAÍ,2022,7683,6331,1352,0.175972927
SC,MONTE CARLO,2022,7162,5615,1547,0.216001117
SC,MONTE CASTELO,2022,7164,5609,1555,0.21705751
SC,MORRO DA FUMAÇA,2022,13471,11125,2346,0.174151882
SC,MORRO GRANDE,2022,2787,2306,481,0.172587011
SC,NAVEGANTES,2022,61069,45961,15108,0.247392294
SC,NOVA ERECHIM,2022,3862,3335,527,0.136457794
SC,NOVA ITABERABA,2022,3942,3430,512,0.129883308
SC,NOVA TRENTO,2022,10774,9105,1669,0.154909968
SC,NOVA VENEZA,2022,12194,10303,1891,0.155076267
SC,NOVO HORIZONTE,2022,2469,2161,308,0.124746861
SC,ORLEANS,2022,19188,15666,3522,0.18355222
SC,OTACÍLIO COSTA,2022,13366,10986,2380,0.178063744
SC,OURO,2022,5819,4862,957,0.164461248
SC,OURO VERDE,2022,2014,1660,354,0.175769613
SC,PAIAL,2022,1940,1597,343,0.176804124
SC,PAINEL,2022,2510,2025,485,0.193227092
SC,PALHOÇA,2022,140096,113932,26164,0.186757652
SC,PALMA SOLA,2022,5726,4527,1199,0.209395739
SC,PALMEIRA,2022,2841,2357,484,0.170362548
SC,PALMITOS,2022,12227,10073,2154,0.176167498
SC,PAPANDUVA,2022,14318,12209,2109,0.147297109
SC,PARAÍSO,2022,3719,2954,765,0.205700457
SC,PASSO DE TORRES,2022,7281,5824,1457,0.200109875
SC,PASSOS MAIA,2022,3328,2719,609,0.182992788
SC,PAULO LOPES,2022,6622,5629,993,0.149954696
SC,PEDRAS GRANDES,2022,4153,3390,763,0.18372261
SC,PENHA,2022,22174,17712,4462,0.201226662
SC,PERITIBA,2022,2744,2363,381,0.138848397
SC,PESCARIA BRAVA,2022,7677,6819,858,0.111762407
SC,PETROLÂNDIA,2022,5399,4708,691,0.127986664
SC,PINHALZINHO,2022,15074,12952,2122,0.140772191
SC,PINHEIRO PRETO,2022,2802,2374,428,0.152748037
SC,PIRATUBA,2022,5079,4347,732,0.144122859
SC,PLANALTO ALEGRE,2022,2761,2373,388,0.140528794
SC,POMERODE,2022,25935,21231,4704,0.181376518
SC,PONTE ALTA,2022,4152,3298,854,0.205684008
SC,PONTE ALTA DO NORTE,2022,2619,2021,598,0.228331424
SC,PONTE SERRADA,2022,7965,6536,1429,0.179409918
SC,PORTO BELO,2022,16821,12947,3874,0.230307354
SC,PORTO UNIÃO,2022,25794,19922,5872,0.227649841
SC,POUSO REDONDO,2022,11816,9754,2062,0.17450914
SC,PRAIA GRANDE,2022,6354,5309,1045,0.16446333
SC,PRESIDENTE CASTELLO BRANCO,2022,1627,1404,223,0.137062077
SC,PRESIDENTE GETÚLIO,2022,13612,11261,2351,0.172715251
SC,PRESIDENTE NEREU,2022,2197,1787,410,0.186618116
SC,PRINCESA,2022,2562,2131,431,0.168227947
SC,QUILOMBO,2022,8187,7017,1170,0.142909491
SC,RANCHO QUEIMADO,2022,3146,2720,426,0.135410045
SC,RIO DAS ANTAS,2022,5308,4265,1043,0.196495855
SC,RIO DO CAMPO,2022,5286,4523,763,0.144343549
SC,RIO DO OESTE,2022,5984,5070,914,0.152740642
SC,RIO DO SUL,2022,51421,41156,10265,0.199626612
SC,RIO DOS CEDROS,2022,8800,7271,1529,0.17375
SC,RIO FORTUNA,2022,4346,3928,418,0.096180396
SC,RIO NEGRINHO,2022,32189,25114,7075,0.219795582
SC,RIO RUFINO,2022,2309,1897,412,0.178432222
SC,RIQUEZA,2022,4088,3360,728,0.178082192
SC,RODEIO,2022,9780,8007,1773,0.181288344
SC,ROMELÂNDIA,2022,3934,3405,529,0.134468734
SC,SALETE,2022,6062,5073,989,0.163147476
SC,SALTINHO,2022,3287,2676,611,0.185883785
SC,SALTO VELOSO,2022,3462,2911,551,0.159156557
SC,SANGÃO,2022,8446,6966,1480,0.175230879
SC,SANTA CECÍLIA,2022,13032,9547,3485,0.267418662
SC,SANTA HELENA,2022,2264,1968,296,0.130742049
SC,SANTA ROSA DE LIMA,2022,1981,1709,272,0.137304392
SC,SANTA ROSA DO SUL,2022,7430,6148,1282,0.172543742
SC,SANTA TEREZINHA,2022,6573,5486,1087,0.165373498
SC,SANTA TEREZINHA DO PROGRESSO,2022,2454,1931,523,0.213121434
SC,SANTIAGO DO SUL,2022,1442,1260,182,0.126213592
SC,SANTO AMARO DA IMPERATRIZ,2022,19055,16265,2790,0.146418263
SC,SAUDADES,2022,7522,6659,863,0.114730125
SC,SCHROEDER,2022,13827,11555,2272,0.164316193
SC,SEARA,2022,14543,11885,2658,0.182768342
SC,SERRA ALTA,2022,2815,2445,370,0.131438721
SC,SIDERÓPOLIS,2022,11105,8742,2363,0.212787033
SC,SOMBRIO,2022,22701,18139,4562,0.20096031
SC,SUL BRASIL,2022,2426,2146,280,0.115416323
SC,SÃO BENTO DO SUL,2022,63102,51285,11817,0.187268232
SC,SÃO BERNARDINO,2022,2463,2103,360,0.146163216
SC,SÃO BONIFÁCIO,2022,2777,2399,378,0.136118113
SC,SÃO CARLOS,2022,8259,7036,1223,0.148080881
SC,SÃO CRISTÓVÃO DO SUL,2022,3475,2692,783,0.225323741
SC,SÃO DOMINGOS,2022,7279,6221,1058,0.145349636
SC,SÃO FRANCISCO DO SUL,2022,39643,30095,9548,0.240849583
SC,SÃO JOAQUIM,2022,19332,15176,4156,0.214980343
SC,SÃO JOSÉ,2022,186561,153056,33505,0.179592734
SC,SÃO JOSÉ DO CEDRO,2022,11360,9259,2101,0.184947183
SC,SÃO JOSÉ DO CERRITO,2022,7444,6243,1201,0.16133799
SC,SÃO JOÃO BATISTA,2022,22763,18127,4636,0.20366384
SC,SÃO JOÃO DO ITAPERIÚ,2022,3745,3079,666,0.177837116
SC,SÃO JOÃO DO OESTE,2022,5127,4390,737,0.143748781
SC,SÃO JOÃO DO SUL,2022,6687,5691,996,0.148945716
SC,SÃO LOURENÇO DO OESTE,2022,19151,15372,3779,0.19732651
SC,SÃO LUDGERO,2022,9205,7869,1336,0.145138512
SC,SÃO MARTINHO,2022,3238,2839,399,0.123224212
SC,SÃO MIGUEL DA BOA VISTA,2022,1716,1421,295,0.171911422
SC,SÃO MIGUEL DO OESTE,2022,31895,25483,6412,0.201034645
SC,SÃO PEDRO DE ALCÂNTARA,2022,4143,3596,547,0.13202993
SC,TAIÓ,2022,14528,11989,2539,0.174765969
SC,TANGARÁ,2022,6601,5527,1074,0.162702621
SC,TIGRINHOS,2022,1999,1677,322,0.16108054
SC,TIJUCAS,2022,31771,24964,6807,0.214251991
SC,TIMBÉ DO SUL,2022,4525,3735,790,0.174585635
SC,TIMBÓ,2022,34153,28092,6061,0.177466108
SC,TIMBÓ GRANDE,2022,5733,4416,1317,0.229722658
SC,TREVISO,2022,3997,3259,738,0.184638479
SC,TREZE DE MAIO,2022,6591,5607,984,0.149294492
SC,TREZE TÍLIAS,2022,6162,5199,963,0.156280428
SC,TROMBUDO CENTRAL,2022,5234,4408,826,0.157814291
SC,TRÊS BARRAS,2022,14947,11689,3258,0.217970161
SC,TUBARÃO,2022,81025,64908,16117,0.198913915
SC,TUNÁPOLIS,2022,4035,3440,595,0.147459727
SC,TURVO,2022,9957,8642,1315,0.132067892
SC,UNIÃO DO OESTE,2022,2470,2127,343,0.138866397
SC,URUBICI,2022,8402,6434,1968,0.234229945
SC,URUPEMA,2022,2362,1986,376,0.15918713
SC,URUSSANGA,2022,17472,13246,4226,0.241872711
SC,VARGEM,2022,2577,2040,537,0.208381839
SC,VARGEM BONITA,2022,4059,3318,741,0.18255728
SC,VARGEÃO,2022,2933,2556,377,0.128537334
SC,VIDAL RAMOS,2022,5349,4596,753,0.140773976
SC,VIDEIRA,2022,38678,30725,7953,0.205620766
SC,VITOR MEIRELES,2022,4472,3645,827,0.184928444
SC,WITMARSUM,2022,3466,2906,560,0.161569533
SC,XANXERÊ,2022,36065,29177,6888,0.190988493
SC,XAVANTINA,2022,3520,3077,443,0.125852273
SC,XAXIM,2022,22602,18911,3691,0.163304132
SC,ZORTÉA,2022,2997,2519,478,0.159492826
SC,ÁGUA DOCE,2022,5459,4444,1015,0.185931489
SC,ÁGUAS DE CHAPECÓ,2022,4761,3895,866,0.18189456
SC,ÁGUAS FRIAS,2022,2495,2183,312,0.1250501
SC,ÁGUAS MORNAS,2022,6054,5307,747,0.123389495
SE,AMPARO DE SÃO FRANCISCO,2022,2686,2238,448,0.166790767
SE,AQUIDABÃ,2022,16699,13422,3277,0.196239296
SE,ARACAJU,2022,423799,352580,71219,0.168049004
SE,ARAUÁ,2022,9356,7440,1916,0.204788371
SE,AREIA BRANCA,2022,13975,11768,2207,0.157924866
SE,BARRA DOS COQUEIROS,2022,25160,19920,5240,0.208267091
SE,BOQUIM,2022,21500,16937,4563,0.212232558
SE,BREJO GRANDE,2022,7242,5703,1539,0.212510356
SE,CAMPO DO BRITO,2022,14828,11806,3022,0.203803615
SE,CANHOBA,2022,4341,3532,809,0.186362589
SE,CANINDÉ DE SÃO FRANCISCO,2022,23643,17608,6035,0.255255255
SE,CAPELA,2022,26114,20277,5837,0.223519951
SE,CARIRA,2022,16930,13503,3427,0.202421737
SE,CARMÓPOLIS,2022,13052,9870,3182,0.243794055
SE,CEDRO DE SÃO JOÃO,2022,5243,4447,796,0.151821476
SE,CRISTINÁPOLIS,2022,14085,10697,3388,0.240539581
SE,CUMBE,2022,4274,3645,629,0.147168928
SE,DIVINA PASTORA,2022,4034,3240,794,0.196826971
SE,ESTÂNCIA,2022,49285,38695,10590,0.214872679
SE,FEIRA NOVA,2022,5782,4851,931,0.161016949
SE,FREI PAULO,2022,13144,10764,2380,0.181071211
SE,GARARU,2022,9162,7462,1700,0.185549007
SE,GENERAL MAYNARD,2022,2939,2364,575,0.195644777
SE,GRACCHO CARDOSO,2022,6042,5113,929,0.153757034
SE,ILHA DAS FLORES,2022,7492,5661,1831,0.24439402
SE,INDIAROBA,2022,13026,10002,3024,0.232151082
SE,ITABAIANA,2022,72255,61514,10741,0.148654072
SE,ITABAIANINHA,2022,30699,25498,5201,0.169419199
SE,ITABI,2022,4542,3727,815,0.179436372
SE,ITAPORANGA D'AJUDA,2022,28108,22522,5586,0.198733457
SE,JAPARATUBA,2022,14444,11077,3367,0.233107173
SE,JAPOATÃ,2022,11107,8928,2179,0.196182588
SE,LAGARTO,2022,77321,64636,12685,0.164056337
SE,LARANJEIRAS,2022,22164,17729,4435,0.20009926
SE,MACAMBIRA,2022,6473,5321,1152,0.177970029
SE,MALHADA DOS BOIS,2022,3894,3133,761,0.195428865
SE,MALHADOR,2022,9979,8309,1670,0.167351438
SE,MARUIM,2022,12872,10265,2607,0.202532629
SE,MOITA BONITA,2022,9382,7793,1589,0.169366873
SE,MONTE ALEGRE DE SERGIPE,2022,11872,9569,2303,0.193985849
SE,MURIBECA,2022,7182,5855,1327,0.184767474
SE,NEÓPOLIS,2022,14091,10784,3307,0.234688808
SE,NOSSA SENHORA APARECIDA,2022,7296,6061,1235,0.169270833
SE,NOSSA SENHORA DA GLÓRIA,2022,28114,23598,4516,0.160631714
SE,NOSSA SENHORA DAS DORES,2022,20853,17235,3618,0.173500216
SE,NOSSA SENHORA DE LOURDES,2022,5730,4753,977,0.170506108
SE,NOSSA SENHORA DO SOCORRO,2022,113347,95736,17611,0.15537244
SE,PACATUBA,2022,11627,8685,2942,0.253031736
SE,PEDRA MOLE,2022,3202,2678,524,0.16364772
SE,PEDRINHAS,2022,7457,5749,1708,0.229046533
SE,PINHÃO,2022,5480,4501,979,0.178649635
SE,PIRAMBU,2022,8349,6348,2001,0.239669421
SE,PORTO DA FOLHA,2022,23505,18933,4572,0.194511806
SE,POÇO REDONDO,2022,21567,16576,4991,0.231418371
SE,POÇO VERDE,2022,19149,15251,3898,0.203561544
SE,PROPRIÁ,2022,19809,16068,3741,0.188853551
SE,RIACHUELO,2022,8110,6482,1628,0.200739827
SE,RIACHÃO DO DANTAS,2022,17268,14185,3083,0.178538337
SE,RIBEIRÓPOLIS,2022,14367,11911,2456,0.17094731
SE,ROSÁRIO DO CATETE,2022,8648,6782,1866,0.215772433
SE,SALGADO,2022,16830,13969,2861,0.169994058
SE,SANTA LUZIA DO ITANHY,2022,11452,8562,2890,0.252357667
SE,SANTA ROSA DE LIMA,2022,4129,3466,663,0.160571567
SE,SANTANA DO SÃO FRANCISCO,2022,5932,4607,1325,0.223364801
SE,SANTO AMARO DAS BROTAS,2022,9821,7270,2551,0.259749516
SE,SIMÃO DIAS,2022,35458,29271,6187,0.174488127
SE,SIRIRI,2022,6674,5414,1260,0.188792328
SE,SÃO CRISTÓVÃO,2022,58720,49623,9097,0.154921662
SE,SÃO DOMINGOS,2022,8269,6264,2005,0.242471883
SE,SÃO FRANCISCO,2022,3528,2917,611,0.173185941
SE,SÃO MIGUEL DO ALEIXO,2022,3962,3203,759,0.191569914
SE,TELHA,2022,3528,2994,534,0.151360544
SE,TOBIAS BARRETO,2022,40738,33486,7252,0.178015612
SE,TOMAR DO GERU,2022,9859,7549,2310,0.234303682
SE,UMBAÚBA,2022,18805,14791,4014,0.213453869
SP,ADAMANTINA,2022,27727,20730,6997,0.252353302
SP,ADOLFO,2022,4310,3239,1071,0.248491879
SP,AGUAÍ,2022,24109,18245,5864,0.24322867
SP,AGUDOS,2022,30532,23350,7182,0.235228613
SP,ALAMBARI,2022,4933,3956,977,0.198053923
SP,ALFREDO MARCONDES,2022,4059,3172,887,0.218526731
SP,ALTAIR,2022,3194,2418,776,0.242955542
SP,ALTINÓPOLIS,2022,12408,9908,2500,0.201482914
SP,ALTO ALEGRE,2022,3648,2796,852,0.233552632
SP,ALUMÍNIO,2022,14521,11473,3048,0.209902899
SP,ALVINLÂNDIA,2022,2719,2073,646,0.237587348
SP,AMERICANA,2022,180219,144210,36009,0.199806902
SP,AMPARO,2022,57481,43903,13578,0.236217185
SP,AMÉRICO BRASILIENSE,2022,28596,22566,6030,0.210868653
SP,AMÉRICO DE CAMPOS,2022,4943,4034,909,0.183896419
SP,ANALÂNDIA,2022,4552,3241,1311,0.288005272
SP,ANDRADINA,2022,45643,34690,10953,0.23997108
SP,ANGATUBA,2022,18400,13821,4579,0.248858696
SP,ANHEMBI,2022,5917,4043,1874,0.316714551
SP,ANHUMAS,2022,3412,2673,739,0.216588511
SP,APARECIDA,2022,28587,22793,5794,0.20267954
SP,APARECIDA D'OESTE,2022,4016,3046,970,0.241533865
SP,APIAÍ,2022,20502,14691,5811,0.283435762
SP,ARAMINA,2022,4613,3517,1096,0.237589421
SP,ARANDU,2022,5821,4464,1357,0.233121457
SP,ARAPEÍ,2022,2485,1880,605,0.243460765
SP,ARARAQUARA,2022,180856,137214,43642,0.241308002
SP,ARARAS,2022,101312,80002,21310,0.210340335
SP,ARAÇARIGUAMA,2022,17269,13129,4140,0.239735943
SP,ARAÇATUBA,2022,153442,118492,34950,0.227773361
SP,ARAÇOIABA DA SERRA,2022,24804,20035,4769,0.192267376
SP,ARCO-ÍRIS,2022,2252,1729,523,0.232238011
SP,AREALVA,2022,6388,4934,1454,0.227614277
SP,AREIAS,2022,3263,2679,584,0.178976402
SP,AREIÓPOLIS,2022,8565,6764,1801,0.210274372
SP,ARIRANHA,2022,6960,5419,1541,0.221408046
SP,ARTUR NOGUEIRA,2022,38456,31239,7217,0.187669024
SP,ARUJÁ,2022,71158,56950,14208,0.199668344
SP,ASPÁSIA,2022,1902,1504,398,0.209253417
SP,ASSIS,2022,74117,55993,18124,0.244532294
SP,ATIBAIA,2022,119604,92668,26936,0.225209859
SP,AURIFLAMA,2022,10967,8831,2136,0.194766117
SP,AVANHANDAVA,2022,7915,6056,1859,0.234870499
SP,AVARÉ,2022,68765,51141,17624,0.256293172
SP,AVAÍ,2022,4145,3143,1002,0.241737033
SP,BADY BASSITT,2022,14352,11399,2953,0.205755295
SP,BALBINOS,2022,1442,1069,373,0.258668516
SP,BANANAL,2022,8809,6703,2106,0.239073675
SP,BARBOSA,2022,5268,4029,1239,0.235193622
SP,BARIRI,2022,25274,18870,6404,0.253382923
SP,BARRA BONITA,2022,30177,23553,6624,0.219504921
SP,BARRA DO CHAPÉU,2022,4793,3634,1159,0.241810974
SP,BARRA DO TURVO,2022,7243,4589,2654,0.366422753
SP,BARRETOS,2022,91066,66310,24756,0.271846792
SP,BARRINHA,2022,24540,19528,5012,0.204237979
SP,BARUERI,2022,279389,225042,54347,0.194520901
SP,BARÃO DE ANTONINA,2022,2790,2102,688,0.246594982
SP,BASTOS,2022,18091,13654,4437,0.245260074
SP,BATATAIS,2022,45053,34442,10611,0.235522607
SP,BAURU,2022,279646,215729,63917,0.22856397
SP,BEBEDOURO,2022,60070,45009,15061,0.250724155
SP,BENTO DE ABREU,2022,2161,1696,465,0.215178158
SP,BERNARDINO DE CAMPOS,2022,8456,6394,2062,0.24385052
SP,BERTIOGA,2022,48327,36221,12106,0.25050179
SP,BILAC,2022,6438,5002,1436,0.223050637
SP,BIRIGUI,2022,89401,69499,19902,0.22261496
SP,BIRITIBA MIRIM,2022,24008,18845,5163,0.215053316
SP,BOA ESPERANÇA DO SUL,2022,10473,8135,2338,0.223240714
SP,BOCAINA,2022,9139,7131,2008,0.219717693
SP,BOFETE,2022,8615,6178,2437,0.2828787
SP,BOITUVA,2022,46475,35544,10931,0.235201721
SP,BOM JESUS DOS PERDÕES,2022,18412,14470,3942,0.2140995
SP,BOM SUCESSO DE ITARARÉ,2022,3342,2601,741,0.221723519
SP,BORACÉIA,2022,3997,3126,871,0.217913435
SP,BORBOREMA,2022,11562,8752,2810,0.243037537
SP,BOREBI,2022,2227,1747,480,0.215536596
SP,BORÁ,2022,1040,848,192,0.184615385
SP,BOTUCATU,2022,106890,86716,20174,0.188736084
SP,BRAGANÇA PAULISTA,2022,135174,105388,29786,0.220353026
SP,BRAÚNA,2022,4283,3453,830,0.1937894
SP,BREJO ALEGRE,2022,2576,2033,543,0.210791925
SP,BRODOWSKI,2022,18175,14167,4008,0.220522696
SP,BROTAS,2022,18945,13871,5074,0.267827923
SP,BURI,2022,15845,11892,3953,0.249479331
SP,BURITAMA,2022,13694,10118,3576,0.261136264
SP,BURITIZAL,2022,3824,3008,816,0.213389121
SP,BÁLSAMO,2022,7490,6008,1482,0.197863818
SP,CABREÚVA,2022,35451,28029,7422,0.209359397
SP,CABRÁLIA PAULISTA,2022,3400,2663,737,0.216764706
SP,CACHOEIRA PAULISTA,2022,25599,19438,6161,0.240673464
SP,CACONDE,2022,14610,10667,3943,0.269883641
SP,CAFELÂNDIA,2022,13255,9858,3397,0.256280649
SP,CAIABU,2022,3314,2756,558,0.168376584
SP,CAIEIRAS,2022,70965,57049,13916,0.196096667
SP,CAIUÁ,2022,3947,2951,996,0.252343552
SP,CAJAMAR,2022,68076,54336,13740,0.201833245
SP,CAJATI,2022,24160,17237,6923,0.286548013
SP,CAJOBI,2022,7852,6048,1804,0.229750382
SP,CAJURU,2022,19333,14477,4856,0.251176744
SP,CAMPINA DO MONTE ALEGRE,2022,4958,3885,1073,0.21641791
SP,CAMPINAS,2022,878715,685756,192959,0.219592245
SP,CAMPO LIMPO PAULISTA,2022,61602,48382,13220,0.214603422
SP,CAMPOS DO JORDÃO,2022,39943,29555,10388,0.260070601
SP,CAMPOS NOVOS PAULISTA,2022,3797,2897,900,0.237029234
SP,CANANÉIA,2022,9977,7745,2232,0.223714543
SP,CANAS,2022,3940,3094,846,0.214720812
SP,CANITAR,2022,3909,3197,712,0.182143771
SP,CAPELA DO ALTO,2022,14907,11594,3313,0.222244583
SP,CAPIVARI,2022,39287,30792,8495,0.216229287
SP,CAPÃO BONITO,2022,36543,27562,8981,0.245765263
SP,CARAGUATATUBA,2022,104071,79528,24543,0.235829386
SP,CARAPICUÍBA,2022,300479,235263,65216,0.217040126
SP,CARDOSO,2022,10262,7164,3098,0.30189047
SP,CASA BRANCA,2022,20884,15330,5554,0.265945221
SP,CASTILHO,2022,15758,12000,3758,0.238482041
SP,CATANDUVA,2022,88190,69566,18624,0.211180406
SP,CATIGUÁ,2022,5822,4729,1093,0.187736173
SP,CAÇAPAVA,2022,74893,58866,16027,0.213998638
SP,CEDRAL,2022,7703,6120,1583,0.205504349
SP,CERQUEIRA CÉSAR,2022,15932,11493,4439,0.278621642
SP,CERQUILHO,2022,36825,28602,8223,0.223299389
SP,CESÁRIO LANGE,2022,13968,10581,3387,0.242482818
SP,CHARQUEADA,2022,13299,10412,2887,0.217083991
SP,CHAVANTES,2022,8782,7325,1457,0.165907538
SP,CLEMENTINA,2022,5527,4357,1170,0.211688077
SP,COLINA,2022,15025,11187,3838,0.255440932
SP,COLÔMBIA,2022,5835,4282,1553,0.266152528
SP,CONCHAL,2022,22084,17729,4355,0.197201594
SP,CONCHAS,2022,13794,9814,3980,0.288531245
SP,CORDEIRÓPOLIS,2022,19855,15772,4083,0.205640896
SP,COROADOS,2022,4183,3339,844,0.201769065
SP,CORONEL MACEDO,2022,3839,3149,690,0.179734306
SP,CORUMBATAÍ,2022,3519,2761,758,0.215402103
SP,COSMORAMA,2022,7136,5592,1544,0.216367713
SP,COSMÓPOLIS,2022,46496,35908,10588,0.227718513
SP,COTIA,2022,185031,149420,35611,0.192459642
SP,CRAVINHOS,2022,27346,20707,6639,0.242777737
SP,CRISTAIS PAULISTA,2022,7464,5785,1679,0.224946409
SP,CRUZEIRO,2022,60339,46562,13777,0.228326621
SP,CRUZÁLIA,2022,2013,1660,353,0.175360159
SP,CUBATÃO,2022,94385,74508,19877,0.210594904
SP,CUNHA,2022,17456,14086,3370,0.193056829
SP,CÁSSIA DOS COQUEIROS,2022,2822,2049,773,0.273919206
SP,CÂNDIDO MOTA,2022,24747,18691,6056,0.244716531
SP,CÂNDIDO RODRIGUES,2022,2576,2008,568,0.220496894
SP,DESCALVADO,2022,25244,19447,5797,0.229638726
SP,DIADEMA,2022,339313,272250,67063,0.197643474
SP,DIRCE REIS,2022,1628,1299,329,0.202088452
SP,DIVINOLÂNDIA,2022,9511,7741,1770,0.186100305
SP,DOBRADA,2022,6540,5175,1365,0.208715596
SP,DOIS CÓRREGOS,2022,19995,14484,5511,0.275618905
SP,DOLCINÓPOLIS,2022,2185,1742,443,0.202745995
SP,DOURADO,2022,7322,5570,1752,0.239278886
SP,DRACENA,2022,35437,26687,8750,0.246917064
SP,DUARTINA,2022,10525,7924,2601,0.247125891
SP,DUMONT,2022,7154,5760,1394,0.194856025
SP,ECHAPORÃ,2022,5294,4027,1267,0.239327541
SP,ELDORADO,2022,11823,8260,3563,0.301361753
SP,ELIAS FAUSTO,2022,14098,11107,2991,0.212157753
SP,ELISIÁRIO,2022,2730,2223,507,0.185714286
SP,EMBAÚBA,2022,2379,1910,469,0.197141656
SP,EMBU DAS ARTES,2022,199656,164723,34933,0.174965941
SP,EMBU-GUAÇU,2022,56441,42103,14338,0.254035187
SP,EMILIANÓPOLIS,2022,2735,2154,581,0.212431444
SP,ENGENHEIRO COELHO,2022,14961,11567,3394,0.226856494
SP,ESPÍRITO SANTO DO PINHAL,2022,33828,25011,8817,0.260642072
SP,ESPÍRITO SANTO DO TURVO,2022,3531,2648,883,0.250070801
SP,ESTIVA GERBI,2022,9442,7614,1828,0.19360305
SP,ESTRELA D'OESTE,2022,7322,5559,1763,0.240781207
SP,ESTRELA DO NORTE,2022,2566,2012,554,0.215900234
SP,EUCLIDES DA CUNHA PAULISTA,2022,7123,4811,2312,0.324582339
SP,FARTURA,2022,13272,10003,3269,0.246308017
SP,FERNANDO PRESTES,2022,5091,3975,1116,0.219210371
SP,FERNANDÓPOLIS,2022,54395,40117,14278,0.262487361
SP,FERNÃO,2022,1590,1206,384,0.241509434
SP,FERRAZ DE VASCONCELOS,2022,133806,106916,26890,0.200962588
SP,FLORA RICA,2022,1589,1152,437,0.275015733
SP,FLOREAL,2022,2665,2146,519,0.194746717
SP,FLORÍNEA,2022,2709,2133,576,0.212624585
SP,FLÓRIDA PAULISTA,2022,8076,6172,1904,0.235760277
SP,FRANCA,2022,247161,194304,52857,0.213856555
SP,FRANCISCO MORATO,2022,131201,101580,29621,0.225768096
SP,FRANCO DA ROCHA,2022,104865,82483,22382,0.213436323
SP,GABRIEL MONTEIRO,2022,2546,2091,455,0.178711705
SP,GARÇA,2022,35572,26565,9007,0.253204768
SP,GASTÃO VIDIGAL,2022,2866,2328,538,0.187718074
SP,GAVIÃO PEIXOTO,2022,4127,3251,876,0.212260722
SP,GENERAL SALGADO,2022,8392,6444,1948,0.232125834
SP,GETULINA,2022,8070,5534,2536,0.31425031
SP,GLICÉRIO,2022,3873,2988,885,0.228505035
SP,GUAIMBÊ,2022,4731,3576,1155,0.244134432
SP,GUAIÇARA,2022,8704,6431,2273,0.261144301
SP,GUAPIARA,2022,15072,10954,4118,0.273221868
SP,GUAPIAÇU,2022,15543,12133,3410,0.219391366
SP,GUARACI,2022,8566,6450,2116,0.247023115
SP,GUARANI D'OESTE,2022,1633,1348,285,0.174525413
SP,GUARANTÃ,2022,5181,3902,1279,0.24686354
SP,GUARARAPES,2022,23442,18790,4652,0.198447231
SP,GUARAREMA,2022,25664,20217,5447,0.21224283
SP,GUARATINGUETÁ,2022,95619,75260,20359,0.212917935
SP,GUARAÇAÍ,2022,6655,5059,1596,0.239819684
SP,GUAREÍ,2022,9536,7557,1979,0.207529362
SP,GUARIBA,2022,29565,22927,6638,0.224522239
SP,GUARUJÁ,2022,235394,187687,47707,0.202668717
SP,GUARULHOS,2022,928404,779867,148537,0.159991771
SP,GUARÁ,2022,14119,11514,2605,0.184503152
SP,GUATAPARÁ,2022,5910,4510,1400,0.236886633
SP,GUAÍRA,2022,30954,21201,9753,0.315080442
SP,GUZOLÂNDIA,2022,3548,2774,774,0.218151071
SP,GÁLIA,2022,5261,3916,1345,0.255654818
SP,HERCULÂNDIA,2022,7228,5512,1716,0.237410072
SP,HOLAMBRA,2022,12290,10172,2118,0.172335232
SP,HORTOLÂNDIA,2022,165269,132600,32669,0.197671675
SP,IACANGA,2022,8605,6744,1861,0.216269611
SP,IACRI,2022,5140,3954,1186,0.2307393
SP,IARAS,2022,4561,3128,1433,0.314185486
SP,IBATÉ,2022,26294,20262,6032,0.229405948
SP,IBIRAREMA,2022,5245,4109,1136,0.216587226
SP,IBIRÁ,2022,9349,7245,2104,0.225050808
SP,IBITINGA,2022,44240,33768,10472,0.236708861
SP,IBIÚNA,2022,63478,47892,15586,0.245533886
SP,ICÉM,2022,6338,4855,1483,0.233985484
SP,IEPÊ,2022,6351,4972,1379,0.21713116
SP,IGARAPAVA,2022,21458,15320,6138,0.286047162
SP,IGARATÁ,2022,9111,7015,2096,0.230051586
SP,IGARAÇU DO TIETÊ,2022,18770,14792,3978,0.211933937
SP,IGUAPE,2022,23763,16797,6966,0.293144805
SP,ILHA COMPRIDA,2022,12846,8732,4114,0.320255332
SP,ILHA SOLTEIRA,2022,21727,15326,6401,0.294610393
SP,ILHABELA,2022,29483,22623,6860,0.232676458
SP,INDAIATUBA,2022,188286,150215,38071,0.20219772
SP,INDIANA,2022,3948,3313,635,0.160840932
SP,INDIAPORÃ,2022,3002,2487,515,0.171552298
SP,INÚBIA PAULISTA,2022,3039,2511,528,0.173741362
SP,IPAUSSU,2022,10758,8336,2422,0.225134783
SP,IPERÓ,2022,21424,16558,4866,0.227128454
SP,IPEÚNA,2022,5651,4394,1257,0.222438506
SP,IPIGUÁ,2022,4376,3424,952,0.217550274
SP,IPORANGA,2022,3480,2469,1011,0.290517241
SP,IPUÃ,2022,11500,9078,2422,0.210608696
SP,IRACEMÁPOLIS,2022,18058,14864,3194,0.176874515
SP,IRAPURU,2022,5041,3744,1297,0.25729022
SP,IRAPUÃ,2022,5698,4189,1509,0.264829765
SP,ITABERÁ,2022,14329,11152,3177,0.221718194
SP,ITAJOBI,2022,12716,9887,2829,0.222475621
SP,ITAJU,2022,3182,2372,810,0.254556882
SP,ITANHAÉM,2022,85042,61260,23782,0.279650055
SP,ITAOCA,2022,3058,2184,874,0.285807717
SP,ITAPECERICA DA SERRA,2022,123695,97857,25838,0.208884757
SP,ITAPETININGA,2022,117697,91168,26529,0.225400817
SP,ITAPEVA,2022,72160,54790,17370,0.240715078
SP,ITAPEVI,2022,163889,130436,33453,0.204119862
SP,ITAPIRA,2022,57492,44400,13092,0.227718639
SP,ITAPIRAPUÃ PAULISTA,2022,3328,2593,735,0.220853365
SP,ITAPORANGA,2022,11656,8544,3112,0.26698696
SP,ITAPURA,2022,3782,2631,1151,0.30433633
SP,ITAPUÍ,2022,10193,7877,2316,0.227214755
SP,ITAQUAQUECETUBA,2022,251377,199410,51967,0.206729335
SP,ITARARÉ,2022,36541,26483,10058,0.275252456
SP,ITARIRI,2022,9780,6983,2797,0.28599182
SP,ITATIBA,2022,85747,68099,17648,0.205814781
SP,ITATINGA,2022,13884,10982,2902,0.209017574
SP,ITAÍ,2022,17555,13396,4159,0.236912561
SP,ITIRAPINA,2022,10161,7906,2255,0.221926976
SP,ITIRAPUÃ,2022,5098,3840,1258,0.246763437
SP,ITOBI,2022,6313,4939,1374,0.217646127
SP,ITU,2022,126674,98766,27908,0.220313561
SP,ITUPEVA,2022,45168,35861,9307,0.206052958
SP,ITUVERAVA,2022,30041,21806,8235,0.274125362
SP,ITÁPOLIS,2022,31419,23219,8200,0.260988574
SP,JABORANDI,2022,5228,4205,1023,0.195677123
SP,JABOTICABAL,2022,55170,40788,14382,0.260685155
SP,JACAREÍ,2022,176834,138893,37941,0.214557155
SP,JACI,2022,5770,4499,1271,0.220277296
SP,JACUPIRANGA,2022,13604,9622,3982,0.292708027
SP,JAGUARIÚNA,2022,44995,35248,9747,0.216624069
SP,JALES,2022,38572,29563,9009,0.233563206
SP,JAMBEIRO,2022,4970,3960,1010,0.203219316
SP,JANDIRA,2022,81159,64508,16651,0.20516517
SP,JARDINÓPOLIS,2022,30546,22481,8065,0.264028023
SP,JARINU,2022,26423,19900,6523,0.246868259
SP,JAÚ,2022,104871,82259,22612,0.215617282
SP,JERIQUARA,2022,3043,2489,554,0.18205718
SP,JOANÓPOLIS,2022,9969,7776,2193,0.219981944
SP,JOSÉ BONIFÁCIO,2022,28393,21671,6722,0.236748494
SP,JOÃO RAMALHO,2022,3432,2727,705,0.20541958
SP,JUMIRIM,2022,2435,1876,559,0.229568789
SP,JUNDIAÍ,2022,330952,267001,63951,0.19323346
SP,JUNQUEIRÓPOLIS,2022,13922,10845,3077,0.221017095
SP,JUQUITIBA,2022,23942,18194,5748,0.240080194
SP,JUQUIÁ,2022,17131,11402,5729,0.334422976
SP,JÚLIO MESQUITA,2022,3791,3014,777,0.204959114
SP,LAGOINHA,2022,5309,4228,1081,0.2036165
SP,LARANJAL PAULISTA,2022,22105,16661,5444,0.246279122
SP,LAVRINHAS,2022,6282,5060,1222,0.194524037
SP,LAVÍNIA,2022,3966,3070,896,0.225920323
SP,LEME,2022,75761,58870,16891,0.222951123
SP,LENÇÓIS PAULISTA,2022,51429,40822,10607,0.206245504
SP,LIMEIRA,2022,230262,182455,47807,0.207620015
SP,LINDÓIA,2022,5927,4687,1240,0.20921208
SP,LINS,2022,58154,43141,15013,0.25815937
SP,LORENA,2022,65120,50446,14674,0.225337838
SP,LOURDES,2022,1954,1473,481,0.24616172
SP,LOUVEIRA,2022,37312,30707,6605,0.177020798
SP,LUCIANÓPOLIS,2022,2130,1697,433,0.203286385
SP,LUCÉLIA,2022,13581,10464,3117,0.229511818
SP,LUIZIÂNIA,2022,3934,3046,888,0.225724453
SP,LUPÉRCIO,2022,3472,2678,794,0.228686636
SP,LUTÉCIA,2022,2450,1922,528,0.215510204
SP,LUÍS ANTÔNIO,2022,10217,7710,2507,0.245375355
SP,MACATUBA,2022,13281,10594,2687,0.202319102
SP,MACAUBAL,2022,6162,4891,1271,0.2062642
SP,MACEDÔNIA,2022,3608,2847,761,0.210920177
SP,MAGDA,2022,2667,2190,477,0.178852643
SP,MAIRINQUE,2022,40243,31265,8978,0.2230947
SP,MAIRIPORÃ,2022,65866,51641,14225,0.215968785
SP,MANDURI,2022,7467,5778,1689,0.226195259
SP,MARABÁ PAULISTA,2022,3104,2329,775,0.249677835
SP,MARACAÍ,2022,10925,8625,2300,0.210526316
SP,MARAPOAMA,2022,2767,2162,605,0.218648356
SP,MARINÓPOLIS,2022,1806,1434,372,0.205980066
SP,MARIÁPOLIS,2022,3060,2406,654,0.21372549
SP,MARTINÓPOLIS,2022,17960,14441,3519,0.195935412
SP,MARÍLIA,2022,181389,139167,42222,0.232770455
SP,MATÃO,2022,66317,52337,13980,0.210805676
SP,MAUÁ,2022,315710,253973,61737,0.195549713
SP,MENDONÇA,2022,5045,3906,1139,0.225768087
SP,MERIDIANO,2022,3649,2971,678,0.18580433
SP,MESÓPOLIS,2022,1784,1389,395,0.221412556
SP,MIGUELÓPOLIS,2022,14772,11698,3074,0.208096399
SP,MINEIROS DO TIETÊ,2022,9361,7207,2154,0.230103621
SP,MIRA ESTRELA,2022,2749,2073,676,0.245907603
SP,MIRACATU,2022,16746,11475,5271,0.314761734
SP,MIRANDÓPOLIS,2022,20051,14380,5671,0.282828787
SP,MIRANTE DO PARANAPANEMA,2022,13268,9955,3313,0.249698523
SP,MIRASSOL,2022,45180,35116,10064,0.222753431
SP,MIRASSOLÂNDIA,2022,4088,3241,847,0.207191781
SP,MOCOCA,2022,53431,38823,14608,0.273399337
SP,MOGI DAS CRUZES,2022,332982,263192,69790,0.209590909
SP,MOGI GUAÇU,2022,119695,93721,25974,0.217001546
SP,MOGI MIRIM,2022,71328,55504,15824,0.221848362
SP,MOMBUCA,2022,3248,2566,682,0.209975369
SP,MONGAGUÁ,2022,50019,35456,14563,0.291149363
SP,MONTE ALEGRE DO SUL,2022,6591,5178,1413,0.21438325
SP,MONTE ALTO,2022,38289,28770,9519,0.248609261
SP,MONTE APRAZÍVEL,2022,17862,13595,4267,0.238887023
SP,MONTE AZUL PAULISTA,2022,14233,11436,2797,0.196515141
SP,MONTE CASTELO,2022,3494,2810,684,0.195764167
SP,MONTE MOR,2022,47499,36370,11129,0.234299669
SP,MONTEIRO LOBATO,2022,3971,3081,890,0.224124906
SP,MONÇÕES,2022,2046,1616,430,0.210166178
SP,MORRO AGUDO,2022,21198,16210,4988,0.235305217
SP,MORUNGABA,2022,10759,8634,2125,0.197509062
SP,MOTUCA,2022,3582,2806,776,0.216638749
SP,MURUTINGA DO SUL,2022,3505,2742,763,0.217689016
SP,NANTES,2022,2333,1759,574,0.246035148
SP,NARANDIBA,2022,4464,3552,912,0.204301075
SP,NATIVIDADE DA SERRA,2022,6008,4352,1656,0.27563249
SP,NAZARÉ PAULISTA,2022,15059,11481,3578,0.237598778
SP,NEVES PAULISTA,2022,7696,5950,1746,0.226871102
SP,NHANDEARA,2022,7776,6172,1604,0.20627572
SP,NIPOÃ,2022,3951,2977,974,0.246519868
SP,NOVA ALIANÇA,2022,5218,4150,1068,0.204676121
SP,NOVA CAMPINA,2022,7126,5537,1589,0.222986248
SP,NOVA CANAÃ PAULISTA,2022,2042,1499,543,0.265915769
SP,NOVA CASTILHO,2022,1287,1017,270,0.20979021
SP,NOVA EUROPA,2022,7786,6009,1777,0.228230157
SP,NOVA GRANADA,2022,15937,12000,3937,0.247035201
SP,NOVA GUATAPORANGA,2022,1988,1506,482,0.242454728
SP,NOVA INDEPENDÊNCIA,2022,3231,2596,635,0.196533581
SP,NOVA LUZITÂNIA,2022,2674,2183,491,0.183620045
SP,NOVA ODESSA,2022,47897,38318,9579,0.199991649
SP,NOVAIS,2022,3670,2934,736,0.200544959
SP,NOVO HORIZONTE,2022,30294,22658,7636,0.252063115
SP,NUPORANGA,2022,5954,4682,1272,0.21363789
SP,OCAUÇU,2022,3289,2683,606,0.184250532
SP,OLÍMPIA,2022,43594,32851,10743,0.246432995
SP,ONDA VERDE,2022,4148,3282,866,0.208775313
SP,ORIENTE,2022,5019,4158,861,0.171548117
SP,ORINDIÚVA,2022,5008,3938,1070,0.213658147
SP,ORLÂNDIA,2022,31757,24061,7696,0.242340271
SP,OSASCO,2022,588106,466340,121766,0.207047709
SP,OSCAR BRESSANE,2022,2520,1937,583,0.231349206
SP,OSVALDO CRUZ,2022,24768,18205,6563,0.264979005
SP,OURINHOS,2022,81097,61530,19567,0.241278962
SP,OURO VERDE,2022,6146,4716,1430,0.232671656
SP,OUROESTE,2022,7527,5967,1560,0.207253886
SP,PACAEMBU,2022,8643,6229,2414,0.279301169
SP,PALESTINA,2022,9211,6955,2256,0.244924547
SP,PALMARES PAULISTA,2022,7852,6348,1504,0.191543556
SP,PALMEIRA D'OESTE,2022,7956,5791,2165,0.272121669
SP,PALMITAL,2022,17310,13072,4238,0.244829578
SP,PANORAMA,2022,10791,8327,2464,0.22833843
SP,PARAGUAÇU PAULISTA,2022,32600,24144,8456,0.259386503
SP,PARAIBUNA,2022,14283,10865,3418,0.239305468
SP,PARANAPANEMA,2022,14286,10981,3305,0.231345373
SP,PARANAPUÃ,2022,3428,2834,594,0.17327888
SP,PARAPUÃ,2022,8284,6245,2039,0.246137132
SP,PARAÍSO,2022,4504,3779,725,0.160968028
SP,PARDINHO,2022,5736,4447,1289,0.22472106
SP,PARIQUERA-AÇU,2022,15626,11571,4055,0.259503392
SP,PARISI,2022,2735,2162,573,0.209506399
SP,PATROCÍNIO PAULISTA,2022,10855,8214,2641,0.243298019
SP,PAULICÉIA,2022,5958,4546,1412,0.236992279
SP,PAULISTÂNIA,2022,1908,1475,433,0.226939203
SP,PAULO DE FARIA,2022,6450,4769,1681,0.260620155
SP,PAULÍNIA,2022,84252,67422,16830,0.199757869
SP,PEDERNEIRAS,2022,34629,26953,7676,0.221663923
SP,PEDRA BELA,2022,5212,3998,1214,0.232924021
SP,PEDRANÓPOLIS,2022,2337,1921,416,0.178005991
SP,PEDREGULHO,2022,11874,9605,2269,0.191089776
SP,PEDREIRA,2022,35328,27311,8017,0.22693048
SP,PEDRINHAS PAULISTA,2022,2781,2220,561,0.201725998
SP,PEDRO DE TOLEDO,2022,8451,5717,2734,0.32351201
SP,PENÁPOLIS,2022,47524,35465,12059,0.253745476
SP,PEREIRA BARRETO,2022,20513,14662,5851,0.285233754
SP,PEREIRAS,2022,6840,5072,1768,0.258479532
SP,PERUÍBE,2022,61798,43631,18167,0.293973915
SP,PIACATU,2022,4682,3680,1002,0.214011106
SP,PIEDADE,2022,43483,32313,11170,0.256882
SP,PILAR DO SUL,2022,23403,17862,5541,0.236764517
SP,PINDAMONHANGABA,2022,122040,95322,26718,0.21892822
SP,PINDORAMA,2022,11420,8713,2707,0.23704028
SP,PINHALZINHO,2022,11749,8827,2922,0.248702017
SP,PIQUEROBI,2022,2968,2389,579,0.195080863
SP,PIQUETE,2022,10087,7971,2116,0.209774958
SP,PIRACAIA,2022,22645,17430,5215,0.230293663
SP,PIRACICABA,2022,307053,239168,67885,0.221085611
SP,PIRAJU,2022,24025,17689,6336,0.263725286
SP,PIRAJUÍ,2022,16218,11976,4242,0.261561228
SP,PIRANGI,2022,8544,6565,1979,0.231624532
SP,PIRAPORA DO BOM JESUS,2022,13292,10755,2537,0.190866687
SP,PIRAPOZINHO,2022,21216,15952,5264,0.24811463
SP,PIRASSUNUNGA,2022,59355,45251,14104,0.237621093
SP,PIRATININGA,2022,9629,7803,1826,0.189635476
SP,PITANGUEIRAS,2022,26840,20312,6528,0.243219076
SP,PLANALTO,2022,4141,3149,992,0.239555663
SP,PLATINA,2022,2714,2113,601,0.221444363
SP,POLONI,2022,4545,3480,1065,0.234323432
SP,POMPÉIA,2022,16871,13186,3685,0.218422145
SP,PONGAÍ,2022,3071,2392,679,0.221100619
SP,PONTAL,2022,29945,23653,6292,0.210118551
SP,PONTALINDA,2022,3288,2474,814,0.24756691
SP,PONTES GESTAL,2022,2358,1771,587,0.248939779
SP,POPULINA,2022,3780,2930,850,0.224867725
SP,PORANGABA,2022,7437,5557,1880,0.252790104
SP,PORTO FELIZ,2022,42612,32690,9922,0.232845208
SP,PORTO FERREIRA,2022,42556,32493,10063,0.236464893
SP,POTIM,2022,13037,10294,2743,0.210401166
SP,POTIRENDABA,2022,13691,10921,2770,0.202322694
SP,POÁ,2022,94984,75653,19331,0.203518487
SP,PRACINHA,2022,1360,1107,253,0.186029412
SP,PRADÓPOLIS,2022,13892,11019,2873,0.206809675
SP,PRAIA GRANDE,2022,247153,187988,59165,0.239386129
SP,PRATÂNIA,2022,4906,3675,1231,0.250917244
SP,PRESIDENTE ALVES,2022,3458,2676,782,0.226142279
SP,PRESIDENTE BERNARDES,2022,11231,8189,3042,0.270857448
SP,PRESIDENTE EPITÁCIO,2022,32095,22811,9284,0.289266241
SP,PRESIDENTE PRUDENTE,2022,180860,134753,46107,0.254931992
SP,PRESIDENTE VENCESLAU,2022,29020,21436,7584,0.261337009
SP,PROMISSÃO,2022,28493,20575,7918,0.277892816
SP,QUADRA,2022,3809,2827,982,0.257810449
SP,QUATÁ,2022,10153,8023,2130,0.20979021
SP,QUEIROZ,2022,3293,2431,862,0.261767385
SP,QUELUZ,2022,7181,5703,1478,0.205820916
SP,QUINTANA,2022,5475,4280,1195,0.21826484
SP,RAFARD,2022,7420,5990,1430,0.192722372
SP,RANCHARIA,2022,24544,18162,6382,0.260022816
SP,REDENÇÃO DA SERRA,2022,4240,3145,1095,0.258254717
SP,REGENTE FEIJÓ,2022,15278,12456,2822,0.184710041
SP,REGINÓPOLIS,2022,4932,3794,1138,0.230738037
SP,REGISTRO,2022,48236,35308,12928,0.26801559
SP,RESTINGA,2022,6750,5187,1563,0.231555556
SP,RIBEIRA,2022,3027,2335,692,0.228609184
SP,RIBEIRÃO BONITO,2022,9247,6697,2550,0.275765113
SP,RIBEIRÃO BRANCO,2022,15086,11342,3744,0.248177118
SP,RIBEIRÃO CORRENTE,2022,4292,3271,1021,0.237884436
SP,RIBEIRÃO DO SUL,2022,3809,3183,626,0.164347598
SP,RIBEIRÃO DOS ÍNDIOS,2022,1882,1526,356,0.189160468
SP,RIBEIRÃO GRANDE,2022,6696,5191,1505,0.224761051
SP,RIBEIRÃO PIRES,2022,90990,72113,18877,0.207462359
SP,RIBEIRÃO PRETO,2022,467661,360806,106855,0.228488157
SP,RIFAINA,2022,4519,3425,1094,0.242088958
SP,RINCÃO,2022,7711,5863,1848,0.239657632
SP,RINÓPOLIS,2022,7698,5835,1863,0.242010912
SP,RIO CLARO,2022,156393,122227,34166,0.218462463
SP,RIO DAS PEDRAS,2022,25114,20266,4848,0.193039739
SP,RIO GRANDE DA SERRA,2022,35759,28268,7491,0.209485724
SP,RIOLÂNDIA,2022,7290,5569,1721,0.236076818
SP,RIVERSUL,2022,4646,3570,1076,0.231597073
SP,ROSANA,2022,15383,10355,5028,0.32685432
SP,ROSEIRA,2022,8587,6946,1641,0.19110283
SP,RUBINÉIA,2022,3278,2446,832,0.253813301
SP,RUBIÁCEA,2022,2286,1876,410,0.179352581
SP,SABINO,2022,4621,3341,1280,0.276996321
SP,SAGRES,2022,2097,1623,474,0.226037196
SP,SALES,2022,5149,3937,1212,0.235385512
SP,SALES OLIVEIRA,2022,8328,6781,1547,0.185758886
SP,SALESÓPOLIS,2022,15422,11984,3438,0.222928284
SP,SALMOURÃO,2022,4045,3104,941,0.23263288
SP,SALTINHO,2022,6868,5665,1203,0.175160163
SP,SALTO,2022,97134,76914,20220,0.208166039
SP,SALTO DE PIRAPORA,2022,30721,24458,6263,0.203867062
SP,SALTO GRANDE,2022,6385,5201,1184,0.185434612
SP,SANDOVALINA,2022,3503,2628,875,0.249785898
SP,SANTA ADÉLIA,2022,11783,8819,2964,0.251548842
SP,SANTA ALBERTINA,2022,5220,4085,1135,0.21743295
SP,SANTA BRANCA,2022,12387,9366,3021,0.243884718
SP,SANTA BÁRBARA D'OESTE,2022,146207,116576,29631,0.202664715
SP,SANTA CLARA D'OESTE,2022,2390,1812,578,0.241841004
SP,SANTA CRUZ DA CONCEIÇÃO,2022,4085,3238,847,0.207343941
SP,SANTA CRUZ DA ESPERANÇA,2022,2193,1645,548,0.249886001
SP,SANTA CRUZ DAS PALMEIRAS,2022,21257,16974,4283,0.201486569
SP,SANTA CRUZ DO RIO PARDO,2022,35939,26813,9126,0.253930271
SP,SANTA ERNESTINA,2022,5013,4114,899,0.179333732
SP,SANTA FÉ DO SUL,2022,27145,20154,6991,0.257542826
SP,SANTA GERTRUDES,2022,18867,15276,3591,0.190332326
SP,SANTA ISABEL,2022,43208,33919,9289,0.214983336
SP,SANTA LÚCIA,2022,6816,5355,1461,0.214348592
SP,SANTA MARIA DA SERRA,2022,4313,3311,1002,0.23232089
SP,SANTA MERCEDES,2022,2743,1975,768,0.279985417
SP,SANTA RITA D'OESTE,2022,2489,1909,580,0.233025311
SP,SANTA RITA DO PASSA QUATRO,2022,20031,15528,4503,0.224801558
SP,SANTA ROSA DE VITERBO,2022,19831,14604,5227,0.263577228
SP,SANTA SALETE,2022,1721,1411,310,0.180127833
SP,SANTANA DA PONTE PENSA,2022,1599,1226,373,0.233270794
SP,SANTANA DE PARNAÍBA,2022,100466,81770,18696,0.186092808
SP,SANTO ANASTÁCIO,2022,15310,12000,3310,0.216198563
SP,SANTO ANDRÉ,2022,583388,461754,121634,0.20849589
SP,SANTO ANTÔNIO DA ALEGRIA,2022,5375,4395,980,0.182325581
SP,SANTO ANTÔNIO DE POSSE,2022,17082,13407,3675,0.215138743
SP,SANTO ANTÔNIO DO ARACANGUÁ,2022,7012,5663,1349,0.192384484
SP,SANTO ANTÔNIO DO JARDIM,2022,5445,4116,1329,0.244077135
SP,SANTO ANTÔNIO DO PINHAL,2022,6390,4957,1433,0.224256651
SP,SANTO EXPEDITO,2022,2766,2155,611,0.220896602
SP,SANTOS,2022,352595,272431,80164,0.22735433
SP,SANTÓPOLIS DO AGUAPEÍ,2022,3253,2555,698,0.214571165
SP,SARAPUÍ,2022,7609,6020,1589,0.208831647
SP,SARUTAIÁ,2022,3171,2459,712,0.224534847
SP,SEBASTIANÓPOLIS DO SUL,2022,3025,2386,639,0.211239669
SP,SERRA AZUL,2022,7766,5829,1937,0.249420551
SP,SERRA NEGRA,2022,23408,17588,5820,0.248632946
SP,SERRANA,2022,34817,26914,7903,0.226986817
SP,SERTÃOZINHO,2022,97072,75584,21488,0.221361464
SP,SETE BARRAS,2022,11314,7817,3497,0.309086088
SP,SEVERÍNIA,2022,12277,9617,2660,0.216665309
SP,SILVEIRAS,2022,5410,4225,1185,0.219038817
SP,SOCORRO,2022,31383,24073,7310,0.232928656
SP,SOROCABA,2022,513603,420665,92938,0.180952993
SP,SUD MENNUCCI,2022,6322,4841,1481,0.23426131
SP,SUMARÉ,2022,198403,155913,42490,0.214160068
SP,SUZANO,2022,228555,183376,45179,0.197672333
SP,SUZANÁPOLIS,2022,2953,2317,636,0.215374196
SP,SÃO BENTO DO SAPUCAÍ,2022,9551,7332,2219,0.232331693
SP,SÃO BERNARDO DO CAMPO,2022,639960,517111,122849,0.19196356
SP,SÃO CAETANO DO SUL,2022,146410,119375,27035,0.184652688
SP,SÃO CARLOS,2022,193957,150423,43534,0.224451811
SP,SÃO FRANCISCO,2022,2530,1910,620,0.245059289
SP,SÃO JOAQUIM DA BARRA,2022,38079,28905,9174,0.240920192
SP,SÃO JOSÉ DA BELA VISTA,2022,6955,5053,1902,0.273472322
SP,SÃO JOSÉ DO BARREIRO,2022,3797,2948,849,0.223597577
SP,SÃO JOSÉ DO RIO PARDO,2022,42715,31518,11197,0.26213274
SP,SÃO JOSÉ DO RIO PRETO,2022,344514,267618,76896,0.223201379
SP,SÃO JOSÉ DOS CAMPOS,2022,558140,446631,111509,0.199786792
SP,SÃO JOÃO DA BOA VISTA,2022,71550,54972,16578,0.231698113
SP,SÃO JOÃO DAS DUAS PONTES,2022,2277,1786,491,0.215634607
SP,SÃO JOÃO DE IRACEMA,2022,1722,1354,368,0.213704994
SP,SÃO JOÃO DO PAU D'ALHO,2022,2025,1623,402,0.198518519
SP,SÃO LOURENÇO DA SERRA,2022,12474,9396,3078,0.246753247
SP,SÃO LUÍS DO PARAITINGA,2022,9986,8010,1976,0.197877028
SP,SÃO MANUEL,2022,31134,24082,7052,0.226504786
SP,SÃO MIGUEL ARCANJO,2022,25689,19597,6092,0.237144303
SP,SÃO PAULO,2022,9314259,7333128,1981131,0.212698724
SP,SÃO PEDRO,2022,27290,20733,6557,0.240271162
SP,SÃO PEDRO DO TURVO,2022,5742,4467,1275,0.222048067
SP,SÃO ROQUE,2022,63625,48263,15362,0.241445972
SP,SÃO SEBASTIÃO,2022,66581,51469,15112,0.226971659
SP,SÃO SEBASTIÃO DA GRAMA,2022,8559,6722,1837,0.214627877
SP,SÃO SIMÃO,2022,12124,9161,2963,0.24439129
SP,SÃO VICENTE,2022,259020,201166,57854,0.22335727
SP,TABAPUÃ,2022,9274,7314,1960,0.211343541
SP,TABATINGA,2022,11620,8835,2785,0.239672978
SP,TABOÃO DA SERRA,2022,223917,178721,45196,0.201842647
SP,TACIBA,2022,4955,4162,793,0.160040363
SP,TAGUAÍ,2022,9245,7304,1941,0.209951325
SP,TAIAÇU,2022,4825,3680,1145,0.237305699
SP,TAIÚVA,2022,4763,3601,1162,0.243963888
SP,TAMBAÚ,2022,15951,12677,3274,0.205253589
SP,TANABI,2022,20685,16003,4682,0.226347595
SP,TAPIRATIBA,2022,10480,7953,2527,0.241125954
SP,TAPIRAÍ,2022,6545,4607,1938,0.296103896
SP,TAQUARAL,2022,2296,1801,495,0.215592334
SP,TAQUARITINGA,2022,40780,30145,10635,0.260789603
SP,TAQUARITUBA,2022,17401,14096,3305,0.189931613
SP,TAQUARIVAÍ,2022,5035,3898,1137,0.225819265
SP,TARABAI,2022,5614,4255,1359,0.242073388
SP,TARUMÃ,2022,11721,9344,2377,0.202798396
SP,TATUÍ,2022,92635,69188,23447,0.253111675
SP,TAUBATÉ,2022,238529,185642,52887,0.221721468
SP,TEJUPÁ,2022,3747,2815,932,0.248732319
SP,TEODORO SAMPAIO,2022,18342,13258,5084,0.277178061
SP,TERRA ROXA,2022,6054,5053,1001,0.165345226
SP,TIETÊ,2022,30783,23693,7090,0.230321931
SP,TIMBURI,2022,2413,1854,559,0.231661832
SP,TORRE DE PEDRA,2022,2587,1933,654,0.252802474
SP,TORRINHA,2022,7379,5710,1669,0.22618241
SP,TRABIJU,2022,1588,1282,306,0.192695214
SP,TREMEMBÉ,2022,30288,23690,6598,0.21784205
SP,TRÊS FRONTEIRAS,2022,5144,3806,1338,0.260108865
SP,TUIUTI,2022,5518,4237,1281,0.232149329
SP,TUPI PAULISTA,2022,11460,8728,2732,0.238394415
SP,TUPÃ,2022,50636,37582,13054,0.257800774
SP,TURIÚBA,2022,1692,1292,400,0.236406619
SP,TURMALINA,2022,1872,1432,440,0.235042735
SP,UBARANA,2022,4639,3503,1136,0.244880362
SP,UBATUBA,2022,76224,56432,19792,0.259655751
SP,UBIRAJARA,2022,4194,3174,1020,0.243204578
SP,UCHOA,2022,8083,6404,1679,0.207719906
SP,UNIÃO PAULISTA,2022,1616,1234,382,0.236386139
SP,URU,2022,1513,1193,320,0.21150033
SP,URUPÊS,2022,11184,8389,2795,0.249910587
SP,URÂNIA,2022,6896,5497,1399,0.20287123
SP,VALENTIM GENTIL,2022,10234,8022,2212,0.216142271
SP,VALINHOS,2022,96405,75473,20932,0.217125668
SP,VALPARAÍSO,2022,16887,12412,4475,0.264996743
SP,VARGEM,2022,6928,4967,1961,0.283054273
SP,VARGEM GRANDE DO SUL,2022,32115,24412,7703,0.239856765
SP,VARGEM GRANDE PAULISTA,2022,40807,32754,8053,0.197343593
SP,VERA CRUZ,2022,7796,6398,1398,0.17932273
SP,VINHEDO,2022,63005,50616,12389,0.196635188
SP,VIRADOURO,2022,12921,10740,2181,0.168794985
SP,VISTA ALEGRE DO ALTO,2022,6139,4762,1377,0.224303633
SP,VITÓRIA BRASIL,2022,1626,1333,293,0.180196802
SP,VOTORANTIM,2022,90853,73271,17582,0.193521403
SP,VOTUPORANGA,2022,72777,55602,17175,0.235994888
SP,VÁRZEA PAULISTA,2022,83504,68053,15451,0.185033052
SP,ZACARIAS,2022,2468,1912,556,0.22528363
SP,ÁGUAS DA PRATA,2022,6331,4851,1480,0.233770336
SP,ÁGUAS DE LINDÓIA,2022,14928,11611,3317,0.222199893
SP,ÁGUAS DE SANTA BÁRBARA,2022,5377,3916,1461,0.271712851
SP,ÁGUAS DE SÃO PEDRO,2022,3976,3138,838,0.210764588
SP,ÁLVARES FLORENCE,2022,3804,2878,926,0.243427971
SP,ÁLVARES MACHADO,2022,19242,14783,4459,0.231732668
SP,ÁLVARO DE CARVALHO,2022,2971,2229,742,0.24974756
SP,ÓLEO,2022,2547,1932,615,0.241460542
TO,ABREULÂNDIA,2022,2340,1900,440,0.188034188
TO,AGUIARNÓPOLIS,2022,3752,3066,686,0.182835821
TO,ALIANÇA DO TOCANTINS,2022,4206,3341,865,0.205658583
TO,ALMAS,2022,5100,4081,1019,0.199803922
TO,ALVORADA,2022,7282,5721,1561,0.214364186
TO,ANANÁS,2022,7163,5788,1375,0.191958677
TO,ANGICO,2022,2683,2126,557,0.207603429
TO,APARECIDA DO RIO NEGRO,2022,3907,3358,549,0.140517021
TO,ARAGOMINAS,2022,4442,3642,800,0.180099054
TO,ARAGUACEMA,2022,4789,3709,1080,0.225516809
TO,ARAGUANÃ,2022,3566,2890,676,0.189568144
TO,ARAGUATINS,2022,21374,16863,4511,0.211050809
TO,ARAGUAÇU,2022,6322,5004,1318,0.20847833
TO,ARAGUAÍNA,2022,112913,93201,19712,0.174576887
TO,ARAPOEMA,2022,4712,3716,996,0.211375212
TO,ARRAIAS,2022,7864,5994,1870,0.237792472
TO,AUGUSTINÓPOLIS,2022,12523,10103,2420,0.19324443
TO,AURORA DO TOCANTINS,2022,3049,2456,593,0.194489997
TO,AXIXÁ DO TOCANTINS,2022,8768,7135,1633,0.186245438
TO,BABAÇULÂNDIA,2022,6311,5320,991,0.157027412
TO,BANDEIRANTES DO TOCANTINS,2022,2636,2225,411,0.155918058
TO,BARRA DO OURO,2022,3604,2916,688,0.190899001
TO,BARROLÂNDIA,2022,4465,3664,801,0.179395297
TO,BERNARDO SAYÃO,2022,3383,2785,598,0.176766184
TO,BOM JESUS DO TOCANTINS,2022,3215,2661,554,0.172317263
TO,BRASILÂNDIA DO TOCANTINS,2022,1802,1515,287,0.159267481
TO,BREJINHO DE NAZARÉ,2022,3862,3227,635,0.164422579
TO,BURITI DO TOCANTINS,2022,6342,5203,1139,0.179596342
TO,CACHOEIRINHA,2022,1859,1459,400,0.215169446
TO,CAMPOS LINDOS,2022,6085,5099,986,0.162037798
TO,CARIRI DO TOCANTINS,2022,3505,2839,666,0.190014265
TO,CARMOLÂNDIA,2022,2334,1914,420,0.179948586
TO,CARRASCO BONITO,2022,3063,2432,631,0.206007183
TO,CASEARA,2022,3766,3052,714,0.189591078
TO,CENTENÁRIO,2022,1817,1542,275,0.151348376
TO,CHAPADA DA NATIVIDADE,2022,2771,2233,538,0.194153735
TO,CHAPADA DE AREIA,2022,2194,1805,389,0.177301732
TO,COLINAS DO TOCANTINS,2022,23111,18501,4610,0.199472113
TO,COLMÉIA,2022,6402,5203,1199,0.187285223
TO,COMBINADO,2022,3675,3012,663,0.180408163
TO,CONCEIÇÃO DO TOCANTINS,2022,3325,2503,822,0.247218045
TO,COUTO MAGALHÃES,2022,4294,3434,860,0.20027946
TO,CRISTALÂNDIA,2022,5385,4367,1018,0.18904364
TO,CRIXÁS DO TOCANTINS,2022,1599,1324,275,0.171982489
TO,DARCINÓPOLIS,2022,4104,3303,801,0.195175439
TO,DIANÓPOLIS,2022,12753,10195,2558,0.200580256
TO,DIVINÓPOLIS DO TOCANTINS,2022,5351,4354,997,0.186320314
TO,DOIS IRMÃOS DO TOCANTINS,2022,4910,3897,1013,0.206313646
TO,DUERÉ,2022,3335,2713,622,0.186506747
TO,ESPERANTINA,2022,6018,4745,1273,0.21153207
TO,FIGUEIRÓPOLIS,2022,4445,3620,825,0.1856018
TO,FILADÉLFIA,2022,6187,5023,1164,0.188136415
TO,FORMOSO DO ARAGUAIA,2022,13706,10907,2799,0.204217131
TO,FÁTIMA,2022,3195,2621,574,0.179655712
TO,GOIANORTE,2022,4363,3661,702,0.160898464
TO,GOIATINS,2022,8132,6647,1485,0.182611904
TO,GUARAÍ,2022,16844,13782,3062,0.181785799
TO,GURUPI,2022,58211,46745,11466,0.196973081
TO,IPUEIRAS,2022,1688,1455,233,0.138033175
TO,ITACAJÁ,2022,5345,4417,928,0.173620206
TO,ITAGUATINS,2022,4416,3548,868,0.196557971
TO,ITAPIRATINS,2022,3253,2692,561,0.172456194
TO,ITAPORÃ DO TOCANTINS,2022,2340,1997,343,0.146581197
TO,JAÚ DO TOCANTINS,2022,2822,2241,581,0.205882353
TO,JUARINA,2022,2039,1721,318,0.155958803
TO,LAGOA DA CONFUSÃO,2022,8516,6816,1700,0.199624237
TO,LAGOA DO TOCANTINS,2022,2992,2466,526,0.175802139
TO,LAJEADO,2022,3279,2589,690,0.210430009
TO,LAVANDEIRA,2022,1772,1436,336,0.189616253
TO,LIZARDA,2022,2961,2364,597,0.201621074
TO,LUZINÓPOLIS,2022,2456,2074,382,0.155537459
TO,MARIANÓPOLIS DO TOCANTINS,2022,3445,2733,712,0.206676343
TO,MATEIROS,2022,1964,1615,349,0.177698574
TO,MAURILÂNDIA DO TOCANTINS,2022,3187,2604,583,0.182930656
TO,MIRACEMA DO TOCANTINS,2022,14101,11311,2790,0.197858308
TO,MIRANORTE,2022,9741,7888,1853,0.190226876
TO,MONTE DO CARMO,2022,4599,3732,867,0.188519243
TO,MONTE SANTO DO TOCANTINS,2022,2376,1938,438,0.184343434
TO,MURICILÂNDIA,2022,2652,2212,440,0.165912519
TO,NATIVIDADE,2022,6575,5234,1341,0.203954373
TO,NAZARÉ,2022,4032,3387,645,0.159970238
TO,NOVA OLINDA,2022,7822,6434,1388,0.177448223
TO,NOVA ROSALÂNDIA,2022,2720,2212,508,0.186764706
TO,NOVO ACORDO,2022,3806,3128,678,0.178139779
TO,NOVO ALEGRE,2022,2056,1638,418,0.203307393
TO,NOVO JARDIM,2022,2136,1718,418,0.195692884
TO,OLIVEIRA DE FÁTIMA,2022,1587,1220,367,0.231253938
TO,PALMAS,2022,198215,164337,33878,0.17091542
TO,PALMEIRANTE,2022,3751,3098,653,0.17408691
TO,PALMEIRAS DO TOCANTINS,2022,4093,3352,741,0.181040801
TO,PALMEIRÓPOLIS,2022,5526,4496,1030,0.186391603
TO,PARANÃ,2022,7934,6003,1931,0.243382909
TO,PARAÍSO DO TOCANTINS,2022,33177,26867,6310,0.190192
TO,PAU D'ARCO,2022,3392,2710,682,0.201061321
TO,PEDRO AFONSO,2022,9872,7986,1886,0.191045381
TO,PEIXE,2022,7059,5587,1472,0.20852812
TO,PEQUIZEIRO,2022,4113,3476,637,0.154874787
TO,PINDORAMA DO TOCANTINS,2022,3574,2905,669,0.187185227
TO,PIRAQUÊ,2022,2193,1805,388,0.176926585
TO,PIUM,2022,5832,4602,1230,0.21090535
TO,PONTE ALTA DO BOM JESUS,2022,3401,2683,718,0.211114378
TO,PONTE ALTA DO TOCANTINS,2022,5365,4300,1065,0.198508854
TO,PORTO ALEGRE DO TOCANTINS,2022,2271,1770,501,0.220607662
TO,PORTO NACIONAL,2022,42885,35587,7298,0.170176052
TO,PRAIA NORTE,2022,5514,4319,1195,0.216721074
TO,PRESIDENTE KENNEDY,2022,2676,2233,443,0.16554559
TO,PUGMIL,2022,2047,1666,381,0.186126038
TO,RECURSOLÂNDIA,2022,2837,2354,483,0.170250264
TO,RIACHINHO,2022,3608,2914,694,0.192350333
TO,RIO DA CONCEIÇÃO,2022,2046,1564,482,0.235581623
TO,RIO DOS BOIS,2022,2502,2035,467,0.186650679
TO,RIO SONO,2022,4056,3458,598,0.147435897
TO,SAMPAIO,2022,3676,2827,849,0.230957563
TO,SANDOLÂNDIA,2022,3346,2718,628,0.18768679
TO,SANTA FÉ DO ARAGUAIA,2022,5149,4189,960,0.18644397
TO,SANTA MARIA DO TOCANTINS,2022,2519,2046,473,0.187772926
TO,SANTA RITA DO TOCANTINS,2022,2018,1672,346,0.171456888
TO,SANTA ROSA DO TOCANTINS,2022,4011,3354,657,0.163799551
TO,SANTA TEREZA DO TOCANTINS,2022,2861,2464,397,0.13876267
TO,SANTA TEREZINHA DO TOCANTINS,2022,2051,1720,331,0.16138469
TO,SILVANÓPOLIS,2022,4486,3637,849,0.189255461
TO,SUCUPIRA,2022,1623,1365,258,0.15896488
TO,SÃO BENTO DO TOCANTINS,2022,4514,3627,887,0.196499778
TO,SÃO FÉLIX DO TOCANTINS,2022,1606,1288,318,0.198007472
TO,SÃO MIGUEL DO TOCANTINS,2022,7802,6671,1131,0.14496283
TO,SÃO SALVADOR DO TOCANTINS,2022,2370,1773,597,0.251898734
TO,SÃO SEBASTIÃO DO TOCANTINS,2022,3196,2582,614,0.192115144
TO,SÃO VALÉRIO,2022,3726,2933,793,0.212828771
TO,SÍTIO NOVO DO TOCANTINS,2022,7694,6366,1328,0.172602028
TO,TABOCÃO,2022,3063,2444,619,0.202089455
TO,TAGUATINGA,2022,10437,8205,2232,0.213854556
TO,TAIPAS DO TOCANTINS,2022,1931,1412,519,0.268772657
TO,TALISMÃ,2022,2561,1985,576,0.224912144
TO,TOCANTINÓPOLIS,2022,15745,13083,2662,0.169069546
TO,TOCANTÍNIA,2022,4874,4109,765,0.156955273
TO,TUPIRAMA,2022,1889,1543,346,0.183165696
TO,TUPIRATINS,2022,1849,1436,413,0.223363981
TO,WANDERLÂNDIA,2022,6904,5548,1356,0.196407879
TO,XAMBIOÁ,2022,8371,6742,1629,0.194600406
ZZ,ABIDJÃ,2022,77,47,30,0.38961039
ZZ,ABU DHABI,2022,2258,989,1269,0.562001771
ZZ,ABUJA,2022,1,1,0,0
ZZ,ACCRA,2022,54,22,32,0.592592593
ZZ,ADIS ABEBA,2022,2,2,0,0
ZZ,AMSTERDÃ,2022,10068,5902,4166,0.413786253
ZZ,AMÃ,2022,1039,585,454,0.436958614
ZZ,ANCARA,2022,58,27,31,0.534482759
ZZ,ARGEL,2022,24,24,0,0
ZZ,ARTIGAS,2022,687,426,261,0.379912664
ZZ,ASSUNÇÃO,2022,2258,1203,1055,0.467227635
ZZ,ASTANA,2022,9,9,0,0
ZZ,ATENAS,2022,1066,451,615,0.576923077
ZZ,ATLANTA,2022,12591,4341,8250,0.655229926
ZZ,BAGDÁ,2022,2,2,0,0
ZZ,BAKU,2022,2,2,0,0
ZZ,BAMAKO,2022,1,1,0,0
ZZ,BANGKOK,2022,222,111,111,0.5
ZZ,BARCELONA,2022,10914,4531,6383,0.584845153
ZZ,BAREIN,2022,50,38,12,0.24
ZZ,BEIRUTE,2022,6347,2975,3372,0.531274618
ZZ,BELGRADO,2022,98,44,54,0.551020408
ZZ,BELMOPAN,2022,11,11,0,0
ZZ,BERLIM,2022,12665,7348,5317,0.419818397
ZZ,BISSAU,2022,79,45,34,0.430379747
ZZ,BOGOTÁ,2022,1574,735,839,0.533036849
ZZ,BOSTON,2022,37159,14473,22686,0.610511585
ZZ,BRATISLAVA,2022,116,71,45,0.387931034
ZZ,BRAZZAVILLE,2022,3,3,0,0
ZZ,BRIDGETOWN,2022,11,11,0,0
ZZ,BRUXELAS,2022,6437,3779,2658,0.412925276
ZZ,BUCARESTE,2022,109,56,53,0.486238532
ZZ,BUDAPESTE,2022,816,621,195,0.238970588
ZZ,BUENOS AIRES,2022,11570,6998,4572,0.395159896
ZZ,CAIENA,2022,3484,1862,1622,0.465556831
ZZ,CAIRO,2022,153,74,79,0.516339869
ZZ,CAMBERRA,2022,4615,2054,2561,0.554929577
ZZ,CANTÃO,2022,382,97,285,0.746073298
ZZ,CARACAS,2022,1244,6,1238,0.995176849
ZZ,CASTRIES,2022,1,1,0,0
ZZ,CHICAGO,2022,10302,2898,7404,0.718695399
ZZ,CHUY,2022,28,28,0,0
ZZ,CIDADE DO CABO,2022,305,169,136,0.445901639
ZZ,CIUDAD DEL ESTE,2022,4627,2936,1691,0.365463583
ZZ,CIUDAD GUAYANA,2022,78,78,0,0
ZZ,COBIJA,2022,3,3,0,0
ZZ,COCHABAMBA,2022,419,262,157,0.374701671
ZZ,COLOMBO,2022,7,7,0,0
ZZ,CONACRI,2022,2,2,0,0
ZZ,CONCEPCIÓN,2022,70,35,35,0.5
ZZ,COPENHAGUE,2022,2302,1258,1044,0.453518679
ZZ,COTONOU,2022,5,5,0,0
ZZ,CÓRDOBA,2022,888,355,533,0.600225225
ZZ,DACAR,2022,108,56,52,0.481481481
ZZ,DAMASCO,2022,202,202,0,0
ZZ,DAR ES SALAAM,2022,34,9,25,0.735294118
ZZ,DOHA,2022,666,372,294,0.441441441
ZZ,DUBLIN,2022,11946,7688,4258,0.356437301
ZZ,DÍLI,2022,91,65,26,0.285714286
ZZ,ENCARNACIÓN,2022,236,133,103,0.436440678
ZZ,ESTOCOLMO,2022,4329,2502,1827,0.422037422
ZZ,FARO,2022,5525,1830,3695,0.668778281
ZZ,FRANKFURT,2022,11563,5089,6474,0.559889302
ZZ,GABORONE,2022,7,7,0,0
ZZ,GENEBRA,2022,10539,4665,5874,0.557358383
ZZ,GEORGETOWN,2022,220,75,145,0.659090909
ZZ,GUATEMALA,2022,291,147,144,0.494845361
ZZ,HAMAMATSU,2022,12189,6469,5720,0.469275576
ZZ,HANÓI,2022,52,22,30,0.576923077
ZZ,HARARE,2022,6,6,0,0
ZZ,HARTFORD,2022,4028,1461,2567,0.637288977
ZZ,HAVANA,2022,89,29,60,0.674157303
ZZ,HELSINQUE,2022,1017,651,366,0.359882006
ZZ,HONG KONG,2022,597,195,402,0.673366834
ZZ,HOUSTON,2022,13804,4249,9555,0.692190669
ZZ,IAUNDÊ,2022,18,18,0,0
ZZ,IEREVAN,2022,11,11,0,0
ZZ,IQUITOS,2022,17,17,0,0
ZZ,ISLAMABADE,2022,16,16,0,0
ZZ,ISTAMBUL,2022,247,131,116,0.469635628
ZZ,JACARTA,2022,157,50,107,0.681528662
ZZ,KATMANDU,2022,33,15,18,0.545454545
ZZ,KIEV,2022,48,48,0,0
ZZ,KINGSTON-JAMAICA,2022,107,13,94,0.878504673
ZZ,KINSHASA,2022,34,17,17,0.5
ZZ,KUAITE,2022,82,46,36,0.43902439
ZZ,KUALA LUMPUR,2022,122,61,61,0.5
ZZ,LA PAZ,2022,393,221,172,0.437659033
ZZ,LAGOS,2022,70,28,42,0.6
ZZ,LIBREVILLE,2022,20,20,0,0
ZZ,LILONGUE,2022,4,4,0,0
ZZ,LIMA,2022,1538,808,730,0.474642393
ZZ,LISBOA,2022,45273,43807,1466,0.032381331
ZZ,LIUBLIANA,2022,124,83,41,0.330645161
ZZ,LOMÉ,2022,4,4,0,0
ZZ,LONDRES,2022,34498,15644,18854,0.546524436
ZZ,LOS ANGELES,2022,11205,4055,7150,0.638107988
ZZ,LUANDA,2022,579,251,328,0.566493955
ZZ,LUSACA,2022,34,14,20,0.588235294
ZZ,MADRI,2022,19866,5815,14051,0.707288835
ZZ,MALABO,2022,4,4,0,0
ZZ,MANILA,2022,193,62,131,0.678756477
ZZ,MANÁGUA,2022,132,86,46,0.348484848
ZZ,MAPUTO,2022,673,317,356,0.52897474
ZZ,MASCATE,2022,95,42,53,0.557894737
ZZ,MENDOZA,2022,240,146,94,0.391666667
ZZ,MEXICO,2022,3950,1434,2516,0.636962025
ZZ,MIAMI,2022,40189,17032,23157,0.576202443
ZZ,MILÃO,2022,20054,7176,12878,0.642166151
ZZ,MONTEVIDÉU,2022,2410,1418,992,0.411618257
ZZ,MONTREAL,2022,9470,5954,3516,0.371277719
ZZ,MOSCOU,2022,222,85,137,0.617117117
ZZ,MUMBAI,2022,55,13,42,0.763636364
ZZ,MUNIQUE,2022,11857,5170,6687,0.56397065
ZZ,NAGÓIA,2022,35651,14962,20689,0.580320328
ZZ,NAIRÓBI,2022,108,51,57,0.527777778
ZZ,NASSAU,2022,67,28,39,0.582089552
ZZ,NICOSIA,2022,75,32,43,0.573333333
ZZ,NOVA DELHI,2022,104,43,61,0.586538462
ZZ,NOVA YORK,2022,27937,11428,16509,0.590936751
ZZ,OSLO,2022,1739,857,882,0.507188039
ZZ,OTTAWA,2022,1855,1158,697,0.37574124
ZZ,PANAMA,2022,1331,706,625,0.469571751
ZZ,PARAMARIBO,2022,1305,493,812,0.622222222
ZZ,PARIS,2022,22629,10966,11663,0.515400592
ZZ,PASO LOS LIBRES,2022,18,18,0,0
ZZ,PEDRO JUAN CABALLERO,2022,626,376,250,0.399361022
ZZ,PEQUIM,2022,282,83,199,0.705673759
ZZ,PORT OF SPAIN,2022,116,35,81,0.698275862
ZZ,PORTO,2022,30098,15694,14404,0.478570005
ZZ,PORTO PRÍNCIPE,2022,45,7,38,0.844444444
ZZ,PRAGA,2022,576,386,190,0.329861111
ZZ,PRAIA,2022,104,68,36,0.346153846
ZZ,PRETÓRIA,2022,711,312,399,0.561181435
ZZ,PUERTO IGUAZÚ,2022,30,4,26,0.866666667
ZZ,PUERTO QUIJARRO,2022,6,6,0,0
ZZ,QUITO,2022,1006,394,612,0.608349901
ZZ,RABAT,2022,103,54,49,0.475728155
ZZ,RAMALLAH,2022,1420,717,703,0.495070423
ZZ,RIADE,2022,181,55,126,0.696132597
ZZ,RIO BRANCO,2022,47,43,4,0.085106383
ZZ,RIVERA,2022,9,9,0,0
ZZ,ROMA,2022,12983,4354,8629,0.664638373
ZZ,SAINT JOHNS,2022,1,1,0,0
ZZ,SALTO DEL GUAIRÁ,2022,780,582,198,0.253846154
ZZ,SANTA CRUZ DE LA SIERRA,2022,2340,1310,1030,0.44017094
ZZ,SANTIAGO,2022,3295,2053,1242,0.37693475
ZZ,SARAJEVO,2022,11,11,0,0
ZZ,SEUL,2022,379,219,160,0.422163588
ZZ,SINGAPURA,2022,814,414,400,0.491400491
ZZ,ST GEORGES DE LOYAPOCK,2022,11,11,0,0
ZZ,SYDNEY,2022,10775,4880,5895,0.547099768
ZZ,SÃO DOMINGOS,2022,414,218,196,0.473429952
ZZ,SÃO FRANCISCO,2022,11698,4122,7576,0.647632074
ZZ,SÃO JOSÉ,2022,656,381,275,0.419207317
ZZ,SÃO SALVADOR,2022,144,79,65,0.451388889
ZZ,SÃO TOMÉ,2022,7,7,0,0
ZZ,SÓFIA,2022,58,35,23,0.396551724
ZZ,TAIPÉ,2022,609,240,369,0.60591133
ZZ,TALIN,2022,252,192,60,0.238095238
ZZ,TBILISI,2022,4,4,0,0
ZZ,TEERÃ,2022,39,18,21,0.538461538
ZZ,TEGUCIGALPA,2022,196,89,107,0.545918367
ZZ,TEL AVIV,2022,2859,984,1875,0.655823715
ZZ,TIRANA,2022,6,6,0,0
ZZ,TORONTO,2022,17755,9930,7825,0.440720924
ZZ,TRÍPOLI,2022,17,17,0,0
ZZ,TUNIS,2022,34,15,19,0.558823529
ZZ,TÓQUIO,2022,28730,13966,14764,0.513887922
ZZ,UAGADUGU,2022,7,7,0,0
ZZ,VANCOUVER,2022,10004,5892,4112,0.411035586
ZZ,VARSÓVIA,2022,580,313,267,0.460344828
ZZ,VATICANO,2022,1,1,0,0
ZZ,VIENA,2022,2927,1624,1303,0.445165699
ZZ,WASHINGTON,2022,14073,5146,8927,0.634335252
ZZ,WELLINGTON,2022,2951,454,2497,0.846153846
ZZ,WINDHOEK,2022,71,40,31,0.436619718
ZZ,XANGAI,2022,700,205,495,0.707142857
ZZ,YANGON,2022,8,8,0,0
ZZ,ZAGREB,2022,99,47,52,0.525252525
ZZ,ZURIQUE,2022,13735,5981,7754,0.564543138
